State,AreaName,All_Poverty,M_Poverty,F_Poverty,FIPS,Med_Income,M_With,M_Without,F_With,F_Without,All_With,All_Without,Incidence_Rate,Avg_Ann_Incidence,RecentTrend,Mortality_Rate,Avg_Ann_Deaths,POPESTIMATE2015,Rising,Falling
AK,"Anchorage Municipality, Alaska",23914,10698,13216,2020,78326,120747,23245,122426,21393,243173,44638,61.5,131,stable,47.3,96,298695,0,0
AK,"Bethel Census Area, Alaska",4364,2199,2165,2050,51012,6396,2708,6627,1774,13023,4482,62.7,6,stable,58.3,5,17946,0,0
AK,"Fairbanks North Star Borough, Alaska",7752,3523,4229,2090,71068,40605,6957,40210,5322,80815,12279,58.1,36,stable,54,31,99631,0,0
AK,"Juneau City and Borough, Alaska",2110,1145,965,2110,85746,13739,2433,13582,2213,27321,4646,35.1,9,stable,34.4,8,32756,0,0
AK,"Kenai Peninsula Borough, Alaska",5558,2596,2962,2122,63684,22391,6435,21668,5433,44059,11868,64.9,39,stable,50.1,28,58059,0,0
AK,"Ketchikan Gateway Borough, Alaska",1640,792,848,2130,64222,5339,1428,5527,1082,10866,2510,88.3,12,stable,70.8,9,13709,0,0
AK,"Kodiak Island Borough, Alaska",1552,962,590,2150,70887,4941,1920,4943,1479,9884,3399,74.7,7,stable,76.2,6,13889,0,0
AK,"Matanuska-Susitna Borough, Alaska",9454,4346,5108,2170,72983,39282,9314,37751,8084,77033,17398,69.7,51,stable,53.9,37,101095,0,0
AK,"Nome Census Area, Alaska",2592,1399,1193,2180,48868,3506,1605,3430,1114,6936,2719,103.6,6,stable,96.1,6,9846,0,0
AK,"North Slope Borough, Alaska",976,532,444,2185,72576,4847,1248,2579,910,7426,2158,153.4,6,stable,124.9,5,9687,0,0
AK,"Sitka City and Borough, Alaska",798,424,374,2220,70376,3635,841,3591,692,7226,1533,44,4,stable,39.6,3,8863,0,0
AK,"Valdez-Cordova Census Area, Alaska",1029,598,431,2261,78810,3670,1292,3566,884,7236,2176,66.1,6,stable,60.8,4,9362,0,0
AL,"Autauga County, Alabama",7057,2983,4074,1001,51281,23500,2781,25417,2727,48917,5508,74.9,43,stable,59.3,34,55347,0,0
AL,"Baldwin County, Alabama",25798,12018,13780,1003,50254,79768,13644,88015,11343,167783,24987,66.9,170,stable,48,121,203709,0,0
AL,"Barbour County, Alabama",6421,2856,3565,1005,32964,9578,2163,10750,1569,20328,3732,74.6,25,stable,61.3,20,26489,0,0
AL,"Bibb County, Alabama",3488,1495,1993,1007,38678,9342,1012,9421,995,18763,2007,86.4,23,stable,67.8,17,22583,0,0
AL,"Blount County, Alabama",9552,4593,4959,1009,45813,24629,3642,25922,3017,50551,6659,69.7,51,stable,59.9,43,57673,0,0
AL,"Bullock County, Alabama",2486,981,1505,1011,31938,4088,1066,4191,762,8279,1828,65.8,9,stable,29.7,4,10696,0,0
AL,"Butler County, Alabama",5094,2073,3021,1013,32229,8129,1223,9482,1236,17611,2459,58.3,17,stable,52.6,15,20154,0,0
AL,"Calhoun County, Alabama",23325,9500,13825,1015,41703,47992,7440,53518,6245,101510,13685,84.2,120,stable,59.9,86,115620,0,0
AL,"Chambers County, Alabama",7273,3091,4182,1017,34177,13928,2198,15131,2476,29059,4674,75.4,34,falling,63.1,29,34123,0,1
AL,"Cherokee County, Alabama",4918,2421,2497,1019,36296,11401,1404,11730,1137,23131,2541,82.4,32,stable,54,21,25859,0,0
AL,"Chilton County, Alabama",8288,3871,4417,1021,41627,18164,3252,18371,3712,36535,6964,73.9,39,stable,66,34,43943,0,0
AL,"Choctaw County, Alabama",3093,1206,1887,1023,33536,5384,934,6098,850,11482,1784,49.2,10,stable,43,9,13170,0,0
AL,"Clarke County, Alabama",6107,2495,3612,1025,32011,9881,1825,11159,1934,21040,3759,69.5,23,stable,43.9,15,24675,0,0
AL,"Clay County, Alabama",2201,902,1299,1027,35327,5518,1022,5839,886,11357,1908,83.3,16,stable,69.1,13,13555,0,0
AL,"Cleburne County, Alabama",2508,1069,1439,1029,38056,6234,1017,6582,1013,12816,2030,74.9,14,stable,59.7,12,15018,0,0
AL,"Coffee County, Alabama",8581,3867,4714,1031,46729,20688,2891,22567,2783,43255,5674,71.5,43,stable,55.1,33,51211,0,0
AL,"Colbert County, Alabama",9406,4124,5282,1033,40576,23057,3007,24955,3003,48012,6010,75.9,57,stable,61.2,46,54354,0,0
AL,"Conecuh County, Alabama",4320,2011,2309,1035,24900,4925,1217,5227,1449,10152,2666,73.5,14,stable,60.2,12,12672,0,0
AL,"Coosa County, Alabama",2073,961,1112,1037,31212,4474,866,4605,805,9079,1671,82.6,14,stable,68.9,11,10724,0,0
AL,"Covington County, Alabama",7515,3263,4252,1039,36444,15536,2520,16877,2437,32413,4957,83,44,stable,71.9,39,37835,0,0
AL,"Crenshaw County, Alabama",2288,1068,1220,1041,36022,5847,939,6229,748,12076,1687,61.5,11,stable,47.3,9,13963,0,0
AL,"Cullman County, Alabama",14814,6760,8054,1043,38971,33641,6024,34557,5978,68198,12002,69.6,73,stable,61.4,63,82005,0,0
AL,"Dale County, Alabama",9306,4092,5214,1045,45028,19228,3179,21602,3161,40830,6340,76.7,44,stable,63.6,37,49565,0,0
AL,"Dallas County, Alabama",14580,5889,8691,1047,27306,16398,2891,19599,2951,35997,5842,76.2,39,stable,65.3,33,41131,0,0
AL,"DeKalb County, Alabama",13133,5783,7350,1049,38192,28735,6363,29767,5509,58502,11872,60.8,51,stable,56.3,46,71130,0,0
AL,"Elmore County, Alabama",10334,4413,5921,1051,53555,31679,3669,36728,3425,68407,7094,78.1,66,stable,66.1,55,81468,0,0
AL,"Escambia County, Alabama",8609,3695,4914,1053,32330,14055,3261,14958,3333,29013,6594,75.5,36,stable,67,32,37789,0,0
AL,"Etowah County, Alabama",20078,8854,11224,1055,39220,42271,7457,46984,6023,89255,13480,81.9,110,stable,67.7,90,103057,0,0
AL,"Fayette County, Alabama",3055,1449,1606,1057,34680,7557,832,7568,751,15125,1583,77.3,19,stable,58.3,14,16759,0,0
AL,"Franklin County, Alabama",7020,2598,4422,1059,35372,12966,2200,13441,2767,26407,4967,72.4,28,stable,65.8,25,31696,0,0
AL,"Geneva County, Alabama",6149,2689,3460,1061,36024,10913,2091,11495,1977,22408,4068,90.3,35,stable,71.2,27,26777,0,0
AL,"Greene County, Alabama",3479,1562,1917,1063,20541,3304,777,4081,484,7385,1261,87.9,10,stable,34.5,5,8479,0,0
AL,"Hale County, Alabama",4011,1638,2373,1065,32714,6051,997,7096,854,13147,1851,71,14,stable,57.8,11,15068,0,0
AL,"Henry County, Alabama",2657,1085,1572,1067,41997,7002,1164,7934,926,14936,2090,66.5,17,falling,56.3,14,17221,0,1
AL,"Houston County, Alabama",18746,7893,10853,1069,41571,42001,6928,47530,6187,89531,13115,70.8,88,stable,56.1,69,104173,0,0
AL,"Jackson County, Alabama",9415,4398,5017,1071,37745,21752,4072,23118,3424,44870,7496,80.9,58,stable,64,46,52419,0,0
AL,"Jefferson County, Alabama",121029,52750,68279,1073,45610,266456,40710,307962,36469,574418,77179,65.1,482,falling,51.5,381,660367,0,1
AL,"Lamar County, Alabama",3382,1302,2080,1075,35450,5876,885,6248,980,12124,1865,80.4,17,stable,72.2,15,13886,0,0
AL,"Lauderdale County, Alabama",16232,6772,9460,1077,43125,38885,5228,42682,5167,81567,10395,69.3,87,stable,56.8,71,92596,0,0
AL,"Lawrence County, Alabama",6225,2780,3445,1079,40003,14223,2042,15306,1773,29529,3815,88.1,37,stable,70,29,33115,0,0
AL,"Lee County, Alabama",34561,15869,18692,1081,44570,64110,8577,69209,7141,133319,15718,59.4,71,stable,57.1,66,156993,0,0
AL,"Limestone County, Alabama",12075,5206,6869,1083,49570,35387,5442,38770,5206,74157,10648,73.4,69,stable,55.9,51,91663,0,0
AL,"Lowndes County, Alabama",3035,1353,1682,1085,25876,4122,883,5036,563,9158,1446,57.6,8,stable,44,6,10458,0,0
AL,"Macon County, Alabama",4636,2060,2576,1087,30738,7564,1437,9797,1011,17361,2448,57.9,15,stable,41.1,10,19105,0,0
AL,"Madison County, Alabama",46436,21195,25241,1089,57993,145531,20878,156037,19760,301568,40638,64.8,236,falling,50.4,179,353089,0,1
AL,"Marengo County, Alabama",5244,2056,3188,1091,32042,8133,1209,9532,1205,17665,2414,61.6,17,stable,51.9,15,20028,0,0
AL,"Marion County, Alabama",5960,2805,3155,1093,32299,12619,1902,13590,1618,26209,3520,74.2,33,stable,51.7,23,30168,0,0
AL,"Marshall County, Alabama",18794,8426,10368,1095,38983,37272,8805,40331,7023,77603,15828,79.4,90,stable,66.6,75,94725,0,0
AL,"Mobile County, Alabama",77917,31927,45990,1097,43809,163094,28997,185337,28790,348431,57787,75.4,347,stable,63.3,289,415395,0,0
AL,"Monroe County, Alabama",6901,2912,3989,1099,27257,8832,1717,9448,2005,18280,3722,62.3,19,stable,52.9,16,21673,0,0
AL,"Montgomery County, Alabama",49918,21699,28219,1101,44369,88803,15281,105296,13407,194099,28688,61,144,falling,49.9,117,226519,0,1
AL,"Morgan County, Alabama",18936,7640,11296,1103,45751,48705,9071,51963,8345,100668,17416,80.4,116,stable,60.5,88,119565,0,0
AL,"Perry County, Alabama",3373,1510,1863,1105,24537,3926,666,4539,757,8465,1423,83.1,11,stable,60.3,8,9652,0,0
AL,"Pickens County, Alabama",4801,2116,2685,1107,30330,8174,1403,8582,1095,16756,2498,65.6,18,stable,57.5,16,20864,0,0
AL,"Pike County, Alabama",8158,3810,4348,1109,32825,13996,1760,15437,1754,29433,3514,61.8,22,stable,47.2,16,33046,0,0
AL,"Randolph County, Alabama",4511,2048,2463,1111,36924,9324,1666,9877,1545,19201,3211,75.5,24,stable,58.5,18,22696,0,0
AL,"Russell County, Alabama",12054,4782,7272,1113,37049,22282,4430,24884,4777,47166,9207,78.7,47,stable,64,38,59660,0,0
AL,"St. Clair County, Alabama",13417,6115,7302,1115,51859,36930,4549,38204,4318,75134,8867,74.7,72,stable,65,61,87074,0,0
AL,"Shelby County, Alabama",16693,7492,9201,1117,70187,88004,9927,95944,7945,183948,17872,57.1,108,stable,47.3,88,208713,0,0
AL,"Sumter County, Alabama",5372,2187,3185,1119,19501,4522,1343,6152,1187,10674,2530,55.5,9,stable,51,9,13103,0,0
AL,"Talladega County, Alabama",17950,7613,10337,1121,35155,32170,5151,36501,4860,68671,10011,74,74,stable,61,61,80862,0,0
AL,"Tallapoosa County, Alabama",9117,3646,5471,1123,39206,16879,2385,18924,2428,35803,4813,70.5,41,stable,54.5,32,40844,0,0
AL,"Tuscaloosa County, Alabama",36274,15124,21150,1125,46565,85157,10782,93413,9656,178570,20438,72.3,135,stable,54.4,100,203976,0,0
AL,"Walker County, Alabama",14598,6480,8118,1127,35843,26799,4750,29620,4050,56419,8800,98.3,89,stable,79.8,71,65294,0,0
AL,"Washington County, Alabama",3200,1367,1833,1129,42811,7140,1263,7114,1352,14254,2615,74.8,16,stable,65.3,14,16804,0,0
AL,"Wilcox County, Alabama",4126,1910,2216,1131,23750,4326,879,4850,921,9176,1800,73.2,11,stable,61.7,9,11059,0,0
AL,"Winston County, Alabama",5157,2035,3122,1133,33194,10251,1462,10390,1726,20641,3188,90.8,31,stable,69.9,24,23877,0,0
AR,"Arkansas County, Arkansas",3705,1514,2191,5001,36411,7568,1273,8583,1068,16151,2341,85.9,21,stable,67.8,17,18433,0,0
AR,"Ashley County, Arkansas",4352,1961,2391,5003,34263,8544,1538,9494,1478,18038,3016,77,23,stable,58.6,17,20838,0,0
AR,"Baxter County, Arkansas",6452,3062,3390,5005,35396,17259,2372,18915,2026,36174,4398,85.6,71,stable,64.3,54,41053,0,0
AR,"Benton County, Arkansas",28804,13213,15591,5007,56239,100609,16255,105249,14411,205858,30666,56.4,129,stable,47,106,249672,0,0
AR,"Boone County, Arkansas",6465,2751,3714,5009,39251,15299,2602,16771,2130,32070,4732,67.7,35,stable,62.6,33,37222,0,0
AR,"Bradley County, Arkansas",3218,1350,1868,5011,33701,4534,989,4797,793,9331,1782,86.3,13,stable,68.3,11,11094,0,0
AR,"Calhoun County, Arkansas",907,409,498,5013,36899,2227,411,2228,320,4455,731,82.5,6,stable,70.2,5,5229,0,0
AR,"Carroll County, Arkansas",5001,2173,2828,5015,36897,11137,2296,11452,2537,22589,4833,59.1,25,stable,47.7,20,27704,0,0
AR,"Chicot County, Arkansas",3385,1350,2035,5017,28913,4159,829,4935,763,9094,1592,76.4,12,stable,70.2,12,11027,0,0
AR,"Clark County, Arkansas",4716,1872,2844,5019,35031,9169,1412,10481,1349,19650,2761,71.6,19,stable,53.3,15,22633,0,0
AR,"Clay County, Arkansas",3324,1472,1852,5021,32552,6214,1308,6654,1090,12868,2398,108.7,26,stable,80.1,20,15109,0,0
AR,"Cleburne County, Arkansas",3676,1696,1980,5023,42905,10744,1960,10629,2018,21373,3978,83.6,38,stable,70.5,32,25467,0,0
AR,"Cleveland County, Arkansas",1751,785,966,5025,43158,3802,415,3698,517,7500,932,77.5,9,stable,67,7,8311,0,0
AR,"Columbia County, Arkansas",5823,2540,3283,5027,36619,9961,1427,10874,1642,20835,3069,72,21,stable,62.6,19,24114,0,0
AR,"Conway County, Arkansas",4709,2344,2365,5029,37732,8987,1322,9349,1275,18336,2597,75,21,stable,55.1,16,21019,0,0
AR,"Craighead County, Arkansas",19715,8920,10795,5031,42475,40807,8090,44480,7051,85287,15141,74.6,74,stable,49.2,48,104354,0,0
AR,"Crawford County, Arkansas",11304,5456,5848,5033,41268,25253,4761,27005,4175,52258,8936,79.1,56,stable,61.8,43,61703,0,0
AR,"Crittenden County, Arkansas",11802,4745,7057,5035,38004,19835,3330,22367,3672,42202,7002,75.6,37,stable,72.2,36,48963,0,0
AR,"Cross County, Arkansas",3461,1459,2002,5037,38103,6927,1358,7966,1005,14893,2363,77.5,18,stable,75.7,17,17284,0,0
AR,"Dallas County, Arkansas",1141,521,620,5039,34084,3076,490,3215,559,6291,1049,82.2,9,stable,74,9,7604,0,0
AR,"Desha County, Arkansas",4029,1628,2401,5041,27197,4813,911,5534,1048,10347,1959,79.2,13,stable,62.8,11,11965,0,0
AR,"Drew County, Arkansas",5023,2381,2642,5043,32819,7468,1560,8028,1292,15496,2852,77.3,17,falling,66.9,15,18778,0,1
AR,"Faulkner County, Arkansas",17768,7625,10143,5045,51223,50314,7392,53062,7289,103376,14681,75.9,78,stable,61.3,61,121552,0,0
AR,"Franklin County, Arkansas",3854,1651,2203,5047,39285,7539,1116,7827,1098,15366,2214,77.1,19,stable,70.1,17,17702,0,0
AR,"Fulton County, Arkansas",2383,1094,1289,5049,37066,5109,849,5326,756,10435,1605,64.7,14,stable,51.3,11,12204,0,0
AR,"Garland County, Arkansas",19802,9205,10597,5051,38733,37960,8263,42017,7421,79977,15684,80.6,121,stable,62.5,95,97177,0,0
AR,"Grant County, Arkansas",2134,943,1191,5053,46171,7806,1002,8160,929,15966,1931,96.1,21,stable,66.9,14,18102,0,0
AR,"Greene County, Arkansas",7572,3161,4411,5055,41286,18199,3041,18855,2801,37054,5842,89.2,45,stable,69.6,34,44196,0,0
AR,"Hempstead County, Arkansas",5940,2685,3255,5057,32122,8639,2045,9584,1824,18223,3869,60.6,17,stable,55.6,16,22084,0,0
AR,"Hot Spring County, Arkansas",5975,2520,3455,5059,40000,13038,2294,13930,2154,26968,4448,94.2,41,stable,75.3,32,33426,0,0
AR,"Howard County, Arkansas",2910,1276,1634,5061,34229,5307,1242,5610,1218,10917,2460,96.2,16,stable,83.1,14,13300,0,0
AR,"Independence County, Arkansas",7783,3287,4496,5063,36265,15227,2627,15939,2658,31166,5285,82.3,38,stable,59.3,27,37052,0,0
AR,"Izard County, Arkansas",2663,1346,1317,5065,32630,5407,912,5285,1083,10692,1995,55.9,13,stable,48.4,11,13445,0,0
AR,"Jackson County, Arkansas",3819,1759,2060,5067,31261,6560,1207,5615,903,12175,2110,104.4,24,stable,83.5,19,17338,0,0
AR,"Jefferson County, Arkansas",17205,7764,9441,5069,36747,28435,4044,32557,4219,60992,8263,97.5,84,stable,67.3,58,71565,0,0
AR,"Johnson County, Arkansas",5574,2492,3082,5071,34139,10777,1961,11377,1613,22154,3574,97.2,29,falling,67.9,20,26141,0,1
AR,"Lafayette County, Arkansas",1731,692,1039,5073,31194,2809,635,3106,588,5915,1223,98.1,12,falling,76.8,9,6996,0,1
AR,"Lawrence County, Arkansas",3899,1796,2103,5075,32379,6805,1419,7182,1309,13987,2728,102.7,25,stable,82.3,20,16779,0,0
AR,"Lee County, Arkansas",2304,969,1335,5077,28393,3231,875,3863,488,7094,1363,57,8,stable,61.9,8,9650,0,0
AR,"Lincoln County, Arkansas",2257,1003,1254,5079,32580,3666,768,4639,745,8305,1513,63.4,10,stable,59,9,13820,0,0
AR,"Little River County, Arkansas",2402,1074,1328,5081,36205,5288,1050,5384,837,10672,1887,79.5,14,stable,56.6,11,12472,0,0
AR,"Logan County, Arkansas",4158,1995,2163,5083,35325,9588,1364,9291,1510,18879,2874,87,27,stable,70.4,22,21714,0,0
AR,"Lonoke County, Arkansas",8697,3814,4883,5085,53631,29648,4044,31951,3462,61599,7506,91.9,62,stable,72.3,49,71645,0,0
AR,"Madison County, Arkansas",3183,1329,1854,5087,37691,6461,1384,6587,1199,13048,2583,67.8,14,stable,58.5,12,15767,0,0
AR,"Marion County, Arkansas",3064,1345,1719,5089,34195,6880,1224,7080,1120,13960,2344,82.7,26,stable,72.5,22,16185,0,0
AR,"Miller County, Arkansas",8594,3519,5075,5091,40317,17114,3465,18108,3769,35222,7234,81.2,41,stable,73.1,36,43908,0,0
AR,"Mississippi County, Arkansas",11781,4964,6817,5093,34612,17754,3431,19318,3527,37072,6958,73.6,36,stable,70.2,34,43738,0,0
AR,"Monroe County, Arkansas",2501,1078,1423,5095,27647,3037,567,3412,620,6449,1187,89.5,11,stable,70.9,9,7399,0,0
AR,"Montgomery County, Arkansas",1620,728,892,5097,33037,3605,881,3865,705,7470,1586,67.5,11,stable,50.4,8,8970,0,0
AR,"Nevada County, Arkansas",2424,1176,1248,5099,30691,3408,824,3731,631,7139,1455,69.2,9,stable,76.1,10,8558,0,0
AR,"Newton County, Arkansas",1637,648,989,5101,34536,3470,553,3379,594,6849,1147,63.9,9,stable,64.9,9,7913,0,0
AR,"Ouachita County, Arkansas",5948,2211,3737,5103,31293,10245,1311,11605,1487,21850,2798,84,30,stable,55.8,20,24358,0,0
AR,"Perry County, Arkansas",1624,509,1115,5105,42346,4607,478,4566,527,9173,1005,98.8,14,stable,78.5,11,10189,0,0
AR,"Phillips County, Arkansas",6882,2991,3891,5107,26844,7585,1824,9003,1794,16588,3618,88.1,23,stable,90.8,23,19513,0,0
AR,"Pike County, Arkansas",2199,999,1200,5109,33097,4360,993,4734,847,9094,1840,87.8,13,stable,63.5,10,10824,0,0
AR,"Poinsett County, Arkansas",5416,2410,3006,5111,33070,9578,2099,10369,1842,19947,3941,114,36,stable,103.5,33,24040,0,0
AR,"Polk County, Arkansas",4878,2389,2489,5113,33702,8138,1727,8596,1765,16734,3492,67.1,22,stable,57.8,18,20216,0,0
AR,"Pope County, Arkansas",11818,5525,6293,5115,39810,26407,4371,27067,4343,53474,8714,86.3,59,stable,72.5,49,63390,0,0
AR,"Prairie County, Arkansas",1766,775,991,5117,35833,3510,522,3650,570,7160,1092,89,12,stable,71.7,9,8291,0,0
AR,"Pulaski County, Arkansas",67908,30871,37037,5119,46140,155362,28215,177974,23280,333336,51495,68,277,stable,54.7,223,392664,0,0
AR,"Randolph County, Arkansas",3651,1897,1754,5121,34044,7056,1477,7688,1129,14744,2606,83.9,21,stable,69.9,18,17469,0,0
AR,"St. Francis County, Arkansas",5857,2661,3196,5123,32105,9159,2301,10761,1502,19920,3803,65.2,20,stable,54.4,16,26589,0,0
AR,"Saline County, Arkansas",10176,4896,5280,5125,55817,48403,6658,52131,5374,100534,12032,73.9,100,stable,52,69,117460,0,0
AR,"Scott County, Arkansas",2165,1061,1104,5127,37321,4655,872,4639,631,9294,1503,91.5,15,stable,63.5,10,10513,0,0
AR,"Searcy County, Arkansas",1855,986,869,5129,33083,3284,668,3306,618,6590,1286,72.1,10,stable,65.9,9,7869,0,0
AR,"Sebastian County, Arkansas",28975,12570,16405,5131,38575,52036,9869,54137,10109,106173,19978,78.2,108,stable,62.1,85,127780,0,0
AR,"Sevier County, Arkansas",3755,1807,1948,5133,36579,6695,1825,6927,1633,13622,3458,70.4,12,stable,60.4,10,17290,0,0
AR,"Sharp County, Arkansas",3944,1700,2244,5135,30691,6873,1357,7332,1315,14205,2672,89.3,26,stable,69.1,21,16912,0,0
AR,"Stone County, Arkansas",3042,1414,1628,5137,29264,5402,908,5237,859,10639,1767,66.5,14,stable,58.2,12,12456,0,0
AR,"Union County, Arkansas",8172,3577,4595,5139,38678,16488,2920,17939,2885,34427,5805,89,46,stable,71.6,38,40144,0,0
AR,"Van Buren County, Arkansas",3574,1438,2136,5141,32312,6656,1663,7101,1386,13757,3049,65.1,19,stable,57.5,17,16771,0,0
AR,"Washington County, Arkansas",41846,19505,22341,5143,43524,89087,18167,92453,14933,181540,33100,67.1,119,stable,52.7,91,225477,0,0
AR,"White County, Arkansas",14175,6412,7763,5145,42554,32331,6006,34463,5243,66794,11249,91.2,81,stable,69.6,61,79161,0,0
AR,"Woodruff County, Arkansas",1612,740,872,5147,28993,2662,686,2965,550,5627,1236,108.5,11,stable,64.9,7,6741,0,0
AR,"Yell County, Arkansas",4009,1862,2147,5149,37804,8865,1837,9456,1380,18321,3217,88.1,24,stable,76,21,21713,0,0
AZ,"Apache County, Arizona",25852,12854,12998,4001,31757,25743,9201,28542,7852,54285,17053,22.9,16,rising,17.7,12,71474,1,0
AZ,"Cochise County, Arizona",21102,8595,12507,4003,45075,47589,6771,55718,6614,103307,13385,46.9,84,stable,37,65,126427,0,0
AZ,"Coconino County, Arizona",28824,13662,15162,4005,50234,53505,13515,57656,11293,111161,24808,36.7,39,stable,25.6,26,139097,0,0
AZ,"Gila County, Arizona",11839,5365,6474,4007,39751,21863,4070,22671,3830,44534,7900,54.3,52,stable,43.8,42,53159,0,0
AZ,"Graham County, Arizona",7446,3377,4069,4009,45964,13834,2323,15164,2098,28998,4421,45.5,16,stable,33.8,12,37666,0,0
AZ,"Greenlee County, Arizona",1215,538,677,4011,51628,4139,584,3643,617,7782,1201,64,6,stable,41.8,4,9529,0,0
AZ,"La Paz County, Arizona",3824,1851,1973,4012,34466,8733,1429,8625,1321,17358,2750,54.4,25,stable,37.7,18,20152,0,0
AZ,"Maricopa County, Arizona",673527,313707,359820,4013,54229,1633881,332342,1747583,275016,3381464,607358,52.2,2059,falling,37.2,"1,463",4167947,0,1
AZ,"Mohave County, Arizona",38874,18410,20464,4015,38488,79661,16608,86521,14132,166182,30740,76.6,280,stable,59.1,216,204737,0,0
AZ,"Navajo County, Arizona",32141,15025,17116,4017,35921,41839,10188,44822,8626,86661,18814,39.6,46,stable,31,35,108277,0,0
AZ,"Pima County, Arizona",187250,86251,100999,4019,46162,404930,70973,444390,59712,849320,130685,50.9,628,stable,37.3,464,1010025,0,0
AZ,"Pinal County, Arizona",63201,28120,35081,4021,49477,155409,24692,163328,23603,318737,48295,45.5,201,falling,33.6,146,406584,0,1
AZ,"Santa Cruz County, Arizona",10970,5162,5808,4023,40140,18361,3991,20136,4339,38497,8330,36.1,19,stable,23.1,12,46461,0,0
AZ,"Yavapai County, Arizona",34117,16249,17868,4025,44748,90324,14466,95351,14369,185675,28835,51.9,203,stable,38.1,151,222255,0,0
AZ,"Yuma County, Arizona",40508,18351,22157,4027,40743,76032,20388,81132,17421,157164,37809,48,115,stable,30.9,74,204275,0,0
CA,"Alameda County, California",194639,87343,107296,6001,75619,681621,88190,732996,70544,1414617,158734,46,687,falling,33.4,495,1638215,0,1
CA,"Amador County, California",4191,1886,2305,6005,54171,14369,1631,15820,1060,30189,2691,58.7,38,stable,47.2,31,37001,0,0
CA,"Butte County, California",47532,23533,23999,6007,43444,92483,16326,98566,12938,191049,29264,61.4,169,stable,46,126,225411,0,0
CA,"Calaveras County, California",5590,2433,3157,6009,53233,19250,2526,20634,1972,39884,4498,52.3,41,stable,40.2,31,44828,0,0
CA,"Colusa County, California",3171,1590,1581,6011,52168,8848,2183,8582,1592,17430,3775,56,11,stable,48.9,10,21482,0,0
CA,"Contra Costa County, California",117915,52269,65646,6013,80185,474034,57497,510094,48931,984128,106428,49.2,554,falling,36.1,404,1126745,0,1
CA,"Del Norte County, California",5207,2385,2822,6015,40847,10237,1462,11012,1310,21249,2772,78.4,25,stable,59.9,19,27254,0,0
CA,"El Dorado County, California",18831,9082,9749,6017,69584,81148,9011,83819,7027,164967,16038,50,116,stable,34.3,79,184452,0,0
CA,"Fresno County, California",252187,117772,134415,6019,45233,379453,88591,410573,66736,790026,155327,50.8,411,stable,36.2,291,974861,0,0
CA,"Glenn County, California",5721,2544,3177,6021,39349,11142,2797,11606,2187,22748,4984,61.2,19,stable,43.8,14,28017,0,0
CA,"Humboldt County, California",28158,13202,14956,6023,42197,54679,11986,56929,10368,111608,22354,56.4,86,stable,42.7,65,135727,0,0
CA,"Imperial County, California",40114,18036,22078,6025,41079,66068,14972,71962,14770,138030,29742,44.3,69,stable,27,42,180191,0,0
CA,"Inyo County, California",2019,907,1112,6027,45955,7794,1063,8106,971,15900,2034,45.7,13,stable,36.5,11,18260,0,0
CA,"Kern County, California",195744,87585,108159,6029,49026,344109,73189,358933,60514,703042,133703,55.7,371,stable,41.4,270,882176,0,0
CA,"Kings County, California",29900,13392,16508,6031,46481,53683,10579,57172,9062,110855,19641,48.8,54,stable,34.4,37,150965,0,0
CA,"Lake County, California",15597,7932,7665,6033,35578,25756,5905,27121,4688,52877,10593,73.7,70,stable,56,53,64591,0,0
CA,"Lassen County, California",3563,1814,1749,6035,51555,10144,1107,9576,1144,19720,2251,60.9,19,stable,51.3,15,31345,0,0
CA,"Los Angeles County, California",1800265,823612,976653,6037,56196,3904322,997326,4230137,837175,8134459,1834501,39.9,3701,falling,31.1,"2,876",10170292,0,1
CA,"Madera County, California",33968,15721,18247,6039,45073,57486,14771,62076,10344,119562,25115,51.8,76,stable,37,53,154998,0,0
CA,"Marin County, California",20964,9707,11257,6041,93257,111107,10737,123055,8224,234162,18961,41.6,145,falling,29.7,106,261221,0,1
CA,"Mariposa County, California",2651,1264,1387,6043,47681,7924,871,8092,729,16016,1600,54.6,17,stable,43.3,13,17531,0,0
CA,"Mendocino County, California",17527,8215,9312,6045,42980,35930,7213,38036,5443,73966,12656,52.2,62,stable,42.1,51,87649,0,0
CA,"Merced County, California",67417,32269,35148,6047,42462,106738,23878,112633,17643,219371,41521,56.9,120,falling,41.1,85,268455,0,1
CA,"Modoc County, California",1673,833,840,6049,37860,3678,797,3881,584,7559,1381,43.7,6,stable,34.8,5,8965,0,0
CA,"Monterey County, California",69475,31992,37483,6053,58783,160439,42733,173038,33794,333477,76527,42.6,163,stable,31.7,121,433898,0,0
CA,"Napa County, California",14020,6923,7097,6055,71379,59832,8787,62340,7435,122172,16222,53.3,92,falling,40.6,70,142456,0,1
CA,"Nevada County, California",12367,5582,6785,6057,56521,41033,6956,43911,5718,84944,12674,47.3,75,stable,31.4,50,98877,0,0
CA,"Orange County, California",395483,182267,213216,6059,76509,1292176,237090,1361429,208099,2653605,445189,44.1,1326,falling,32.6,979,3169776,0,1
CA,"Placer County, California",32427,15480,16947,6061,73948,158349,18543,172630,13950,330979,32493,49.6,222,stable,34.3,154,375391,0,0
CA,"Plumas County, California",2687,1168,1519,6063,47333,8108,1407,8361,926,16469,2333,44.2,15,stable,36.5,12,18409,0,0
CA,"Riverside County, California",379985,175705,204280,6065,56603,916746,207979,974823,175978,1891569,383957,47.2,1031,stable,37.1,808,2361026,0,0
CA,"Sacramento County, California",262251,122854,139397,6067,55987,607503,96682,666343,79357,1273846,176039,56.9,793,stable,42.6,595,1501335,0,0
CA,"San Benito County, California",6202,2722,3480,6069,71077,24382,4284,25574,3155,49956,7439,40.2,18,stable,29.9,15,58792,0,0
CA,"San Bernardino County, California",397766,178898,218868,6071,53433,825890,177988,886691,159538,1712581,337526,49.5,807,falling,39,625,2128133,0,1
CA,"San Diego County, California",454876,210952,243924,6073,64309,1301142,234576,1380888,206949,2682030,441525,49,1485,falling,36,"1,097",3299521,0,1
CA,"San Francisco County, California",109524,52571,56953,6075,81294,384329,40788,380762,30288,765091,71076,49,459,falling,34.4,324,864816,0,1
CA,"San Joaquin County, California",129390,59724,69666,6077,53274,290726,55049,311300,42817,602026,97866,56.8,353,stable,44.8,277,726106,0,0
CA,"San Luis Obispo County, California",38630,18816,19814,6079,60691,117241,17433,120210,14696,237451,32129,46.9,161,stable,34.7,120,281401,0,0
CA,"San Mateo County, California",59232,26750,32482,6081,93623,330032,36082,349501,29233,679533,65315,45.3,375,falling,30.4,254,765135,0,1
CA,"Santa Barbara County, California",68017,32772,35245,6083,63985,175112,37490,186064,30108,361176,67598,42.1,189,stable,29.3,134,444769,0,0
CA,"Santa Clara County, California",175690,81461,94229,6085,96310,840137,93794,849441,75798,1689578,169592,41.1,705,stable,27.6,472,1918044,0,0
CA,"Santa Cruz County, California",39053,17482,21571,6087,67256,115040,17940,121172,13853,236212,31793,37.6,99,stable,28.4,74,274146,0,0
CA,"Shasta County, California",31707,14584,17123,6089,44620,73691,13334,79630,10912,153321,24246,62.5,154,stable,48.6,119,179533,0,0
CA,"Siskiyou County, California",10026,4814,5212,6093,37170,18728,2957,19573,2444,38301,5401,60.5,44,stable,48,35,43554,0,0
CA,"Solano County, California",55534,24891,30643,6095,66828,175710,24415,193177,19391,368887,43806,58.1,246,stable,44.3,186,436092,0,0
CA,"Sonoma County, California",57179,26643,30536,6097,64240,208988,31276,224981,25613,433969,56889,49.5,288,falling,38.4,223,502146,0,1
CA,"Stanislaus County, California",105927,48153,57774,6099,50125,217812,41373,231370,33483,449182,74856,57.4,273,stable,42.1,200,538388,0,0
CA,"Sutter County, California",16743,7675,9068,6101,52017,38662,7984,41134,6258,79796,14242,56.3,56,stable,48,48,96463,0,0
CA,"Tehama County, California",12313,5604,6709,6103,41001,26592,4414,27736,3843,54328,8257,65.2,54,falling,49.9,40,63308,0,1
CA,"Trinity County, California",2562,1226,1336,6105,34974,5379,1332,5355,1094,10734,2426,66.6,15,stable,52.4,11,13069,0,0
CA,"Tulare County, California",125775,60834,64941,6107,42031,180176,44296,190135,35140,370311,79436,47.9,174,falling,40.7,145,459863,0,1
CA,"Tuolumne County, California",7010,3092,3918,6109,50306,22107,3017,23557,2159,45664,5176,58,52,stable,37.6,35,53709,0,0
CA,"Ventura County, California",91880,42180,49700,6111,77348,347674,63746,371628,51009,719302,114755,41.5,344,falling,30.3,250,850536,0,1
CA,"Yolo County, California",39688,18185,21503,6113,54989,87463,12481,95866,9946,183329,22427,42.3,74,stable,34.3,60,213016,0,0
CA,"Yuba County, California",15862,7384,8478,6115,46892,29943,5357,31024,4787,60967,10144,68.1,44,stable,55.3,35,74492,0,0
CO,"Adams County, Colorado",64241,29134,35107,8001,58946,189978,44652,197245,35868,387223,80520,52.6,182,stable,39,133,491337,0,0
CO,"Alamosa County, Colorado",4396,1771,2625,8003,32395,6483,1147,7379,814,13862,1961,47.9,7,stable,30.5,5,16496,0,0
CO,"Arapahoe County, Colorado",67679,31140,36539,8005,63265,252809,43197,271608,35597,524417,78794,47.5,253,stable,33.7,177,631096,0,0
CO,"Archuleta County, Colorado",1405,661,744,8007,46646,4749,1386,4721,1212,9470,2598,31.7,6,falling,22.7,4,12352,0,1
CO,"Boulder County, Colorado",42167,20822,21345,8013,70961,140104,14558,141062,12224,281166,26782,35.5,94,stable,24.3,65,319372,0,0
CO,"Broomfield County, Colorado",3930,1582,2348,8014,81898,27449,2447,28789,1679,56238,4126,48.4,23,stable,37.8,18,65065,0,0
CO,"Chaffee County, Colorado",1502,647,855,8015,51092,7356,1459,7403,1018,14759,2477,36.9,11,stable,30.6,8,18658,0,0
CO,"Conejos County, Colorado",1491,735,756,8021,36652,3320,750,3543,595,6863,1345,34.7,4,stable,32.6,3,8130,0,0
CO,"Delta County, Colorado",4716,2086,2630,8029,42452,11449,2812,12536,2420,23985,5232,46.3,23,falling,35,17,29979,0,1
CO,"Denver County, Colorado",110299,52215,58084,8031,53637,267697,53725,282385,39310,550082,93035,48.5,264,stable,36.2,196,682545,0,0
CO,"Douglas County, Colorado",12110,5653,6457,8035,102964,143468,8170,147150,7231,290618,15401,37.1,75,stable,24,48,322387,0,0
CO,"Eagle County, Colorado",4780,2769,2011,8037,72214,22270,5524,20430,4256,42700,9780,28.3,9,stable,14.9,5,53605,0,0
CO,"Elbert County, Colorado",1649,819,830,8039,84963,10597,1313,10716,1135,21313,2448,47.5,10,stable,36.5,7,24735,0,0
CO,"El Paso County, Colorado",75033,33973,41060,8041,58206,266035,37593,290199,30351,556234,67944,50.3,282,falling,35.7,196,674471,0,1
CO,"Fremont County, Colorado",6272,2828,3444,8043,40423,14966,2281,16985,1946,31951,4227,56.4,38,stable,41.3,28,46692,0,0
CO,"Garfield County, Colorado",6786,3452,3334,8045,56590,20773,7848,21056,6668,41829,14516,43.2,19,stable,26.1,11,58095,0,0
CO,"Grand County, Colorado",1543,733,810,8049,63628,6134,1509,5371,1336,11505,2845,47.5,6,stable,38.5,4,14615,0,0
CO,"Huerfano County, Colorado",1171,646,525,8055,31715,2602,584,2728,405,5330,989,59.2,8,stable,43.5,6,6492,0,0
CO,"Jefferson County, Colorado",46423,20756,25667,8059,70164,240890,28944,253891,22256,494781,51200,43.7,262,stable,30.5,179,565524,0,0
CO,"Kit Carson County, Colorado",1157,444,713,8063,40603,2923,574,3029,542,5952,1116,55.1,6,stable,36,4,7758,0,0
CO,"La Plata County, Colorado",5432,2273,3159,8067,60278,21982,4645,22642,3415,44624,8060,34.4,19,stable,24.6,13,54688,0,0
CO,"Larimer County, Colorado",42338,19766,22572,8069,59805,139780,17059,145434,13510,285214,30569,39.7,124,stable,29.8,92,333577,0,0
CO,"Las Animas County, Colorado",2055,1039,1016,8071,45067,5944,1071,6018,970,11962,2041,46.9,10,stable,37.3,8,14058,0,0
CO,"Lincoln County, Colorado",624,223,401,8073,39005,1416,115,2073,159,3489,274,53.5,4,stable,46.9,3,5557,0,0
CO,"Logan County, Colorado",3529,1745,1784,8075,42319,9154,2218,8832,1110,17986,3328,36.4,10,stable,30.4,8,22036,0,0
CO,"Mesa County, Colorado",22545,10438,12107,8077,49322,62209,10578,64142,9629,126351,20207,56.1,102,stable,42.4,77,148513,0,0
CO,"Moffat County, Colorado",1462,703,759,8081,51387,5485,1268,5327,913,10812,2181,40,6,stable,37.3,5,12937,0,0
CO,"Montezuma County, Colorado",4550,2193,2357,8083,43553,9654,2983,10467,2391,20121,5374,40.2,15,stable,31,12,26168,0,0
CO,"Montrose County, Colorado",7644,3476,4168,8085,43999,16045,3781,16771,3816,32816,7597,49.6,28,stable,40.3,24,40946,0,0
CO,"Morgan County, Colorado",3218,1172,2046,8087,48450,12045,1757,12343,1744,24388,3501,49.5,16,stable,41.2,13,28360,0,0
CO,"Otero County, Colorado",4396,2097,2299,8089,32311,7592,1415,8057,1311,15649,2726,40.5,11,stable,29.3,8,18343,0,0
CO,"Park County, Colorado",1170,563,607,8093,56969,7209,1208,6891,733,14100,1941,35.8,8,falling,25.5,4,16510,0,1
CO,"Prowers County, Colorado",2264,993,1271,8099,40179,5046,965,5307,732,10353,1697,67.3,10,stable,58.6,9,11954,0,0
CO,"Pueblo County, Colorado",31017,14201,16816,8101,41286,66883,10100,73703,6961,140586,17061,49.8,99,stable,36.8,74,163591,0,0
CO,"Rio Grande County, Colorado",2198,1070,1128,8105,39672,4698,960,4985,882,9683,1842,29.2,5,stable,21,3,11543,0,0
CO,"Routt County, Colorado",2369,1338,1031,8107,64963,10917,1385,9954,1252,20871,2637,31.5,6,stable,24.3,4,24130,0,0
CO,"Summit County, Colorado",3949,1928,2021,8117,67983,12116,3713,10374,2654,22490,6367,14.8,4,stable,21.6,3,30257,0,0
CO,"Teller County, Colorado",1728,826,902,8119,62372,10383,1275,10200,1245,20583,2520,41.1,11,stable,26.4,8,23385,0,0
CO,"Weld County, Colorado",34007,15469,18538,8123,60572,117241,16815,118408,15738,235649,32553,45.7,101,stable,35.2,76,285174,0,0
CO,"Yuma County, Colorado",1451,599,852,8125,43105,4057,678,4550,756,8607,1434,62.5,8,stable,40.3,5,10146,0,0
CT,"Fairfield County, Connecticut",82743,36089,46654,9001,84233,398180,55567,432919,44703,831099,100270,54.9,571,falling,34.5,365,948053,0,1
CT,"Hartford County, Connecticut",104196,46770,57426,9003,66395,390154,34444,430902,26115,821056,60559,62,662,falling,40.4,439,895841,0,1
CT,"Litchfield County, Connecticut",12893,6253,6640,9005,72061,84207,7090,88395,5185,172602,12275,62.5,160,stable,38.7,99,183603,0,0
CT,"Middlesex County, Connecticut",10710,4712,5998,9007,79893,74580,5483,79505,3690,154085,9173,65.7,144,stable,44.2,96,164063,0,0
CT,"New Haven County, Connecticut",108533,46592,61941,9009,61640,371693,38036,413529,28371,785222,66407,70.2,718,falling,44.9,467,859470,0,1
CT,"New London County, Connecticut",25766,11243,14523,9011,66233,117687,9625,127638,6301,245325,15926,68.7,224,stable,43.3,142,271863,0,0
CT,"Tolland County, Connecticut",9511,4404,5107,9013,79626,69525,4026,72384,2882,141909,6908,62.7,98,stable,41.8,65,151420,0,0
CT,"Windham County, Connecticut",11999,4937,7062,9015,59392,52591,4669,55081,3442,107672,8111,65,86,stable,47.5,62,116573,0,0
DC,"District of Columbia, District of Columbia",110365,48069,62296,11001,70848,276285,22198,323314,14813,599599,37011,59,351,stable,40.6,240,672228,0,0
DE,"Kent County, Delaware",22074,9294,12780,10001,54976,71860,7217,81320,5658,153180,12875,79.2,147,stable,57,105,173533,0,0
DE,"New Castle County, Delaware",60487,25747,34740,10003,65476,236835,22972,262252,19167,499087,42139,67.3,387,stable,50.3,289,556779,0,0
DE,"Sussex County, Delaware",25754,11078,14676,10005,53751,87643,11295,96771,8798,184414,20093,74.2,239,stable,53.1,171,215622,0,0
FL,"Alachua County, Florida",58203,27526,30677,12001,43073,103064,18026,114762,15667,217826,33693,67.8,160,stable,48.6,114,259964,0,0
FL,"Baker County, Florida",4393,1849,2544,12003,47121,10298,1772,11081,1480,21379,3252,99.5,27,stable,75.2,21,27420,0,0
FL,"Bay County, Florida",26235,11556,14679,12005,47368,68041,15563,74296,13119,142337,28682,88.4,185,stable,66.5,139,181635,0,0
FL,"Bradford County, Florida",4896,2208,2688,12007,41606,9447,2538,10148,1770,19595,4308,82.1,28,stable,65.8,23,26928,0,0
FL,"Brevard County, Florida",76460,35131,41329,12009,48925,223646,43920,244237,36499,467883,80419,74.2,647,falling,55.4,487,568088,0,1
FL,"Broward County, Florida",265880,119303,146577,12011,51968,701051,186805,768123,176118,1469174,362923,53.5,1129,falling,38.7,827,1896425,0,1
FL,"Calhoun County, Florida",2407,1034,1373,12013,34510,4924,1212,5067,1382,9991,2594,78.2,15,stable,68.4,13,14462,0,0
FL,"Charlotte County, Florida",19760,8772,10988,12015,44244,65469,12778,72012,12279,137481,25057,62.3,233,falling,45.3,175,173115,0,1
FL,"Citrus County, Florida",23903,10602,13301,12017,38312,56990,9243,62626,8906,119616,18149,79.7,244,stable,64.2,200,141058,0,0
FL,"Clay County, Florida",20580,9158,11422,12019,58290,81814,12802,87934,11830,169748,24632,79.2,161,stable,58.5,117,203967,0,0
FL,"Collier County, Florida",47436,22674,24762,12021,57452,129514,37119,141173,31428,270687,68547,43.3,268,falling,30.5,194,357305,0,1
FL,"Columbia County, Florida",12498,5458,7040,12023,41926,25684,4960,27284,5238,52968,10198,88.2,77,stable,62.8,54,68348,0,0
FL,"DeSoto County, Florida",10123,5668,4455,12027,35165,12016,6079,12514,2527,24530,8606,57.7,28,stable,45,22,35458,0,0
FL,"Dixie County, Florida",3061,1320,1741,12029,36292,5773,1510,5975,1316,11748,2826,100,26,stable,73.8,19,16203,0,0
FL,"Duval County, Florida",150792,66314,84478,12031,47690,348726,69632,393413,61083,742139,130715,78.1,685,stable,53.8,465,913010,0,0
FL,"Escambia County, Florida",45308,20987,24321,12033,45390,116879,22448,132565,18328,249444,40776,78.4,281,stable,58.8,211,311003,0,0
FL,"Flagler County, Florida",14814,6979,7835,12035,47866,40356,7640,45070,7344,85426,14984,67.7,120,stable,49.7,90,105392,0,0
FL,"Franklin County, Florida",1977,872,1105,12037,40401,3898,1082,3899,903,7797,1985,93.4,16,stable,77.7,12,11761,0,0
FL,"Gadsden County, Florida",11907,5937,5970,12039,35567,16381,4465,19672,3451,36053,7916,66.4,38,stable,51.5,29,46036,0,0
FL,"Gilchrist County, Florida",3598,1705,1893,12041,40623,6212,1652,6150,1794,12362,3446,74.3,17,stable,71.7,17,17199,0,0
FL,"Glades County, Florida",2408,1150,1258,12043,34877,4492,1533,4683,1214,9175,2747,54.9,13,stable,41.5,9,13670,0,0
FL,"Gulf County, Florida",1924,830,1094,12045,41788,5660,1346,5374,1079,11034,2425,92.6,20,stable,65.2,14,15871,0,0
FL,"Hamilton County, Florida",3234,1467,1767,12047,35048,4472,903,4844,828,9316,1731,67.8,12,stable,53.2,9,14295,0,0
FL,"Hardee County, Florida",7029,3262,3767,12049,35457,9773,3558,9673,2790,19446,6348,69,20,stable,49.1,14,27502,0,0
FL,"Hendry County, Florida",9696,4898,4798,12051,36771,12624,6343,12932,4928,25556,11271,65.2,25,stable,47.8,18,39119,0,0
FL,"Hernando County, Florida",27375,12662,14713,12053,40945,69276,13919,77784,11982,147060,25901,74.9,241,stable,55.8,183,178439,0,0
FL,"Highlands County, Florida",18863,9056,9807,12055,35093,39100,8307,42730,7146,81830,15453,73.3,155,stable,51.4,110,99491,0,0
FL,"Hillsborough County, Florida",217684,98476,119208,12057,50579,513975,113535,566133,97187,1080108,210722,69.7,895,falling,48.3,616,1349050,0,1
FL,"Holmes County, Florida",4903,2374,2529,12059,35020,6781,1939,7454,1544,14235,3483,71.2,20,stable,68.6,18,19324,0,0
FL,"Indian River County, Florida",20272,8950,11322,12061,45798,55362,12465,62107,11598,117469,24063,67,180,stable,51.2,143,147919,0,0
FL,"Jackson County, Florida",9090,4056,5034,12063,35098,17614,2648,18268,2817,35882,5465,48.4,31,stable,52.8,34,48599,0,0
FL,"Jefferson County, Florida",1862,741,1121,12065,43355,4579,594,5855,714,10434,1308,42.5,9,stable,44.8,9,14081,0,0
FL,"Lafayette County, Florida",1425,563,862,12067,35864,2563,950,2877,624,5440,1574,97.3,9,stable,78.3,7,8663,0,0
FL,"Lake County, Florida",42497,19644,22853,12069,46403,125259,22303,138043,21490,263302,43793,76,400,stable,52.9,279,325875,0,0
FL,"Lee County, Florida",105166,48604,56562,12071,48537,255054,66636,280570,55914,535624,122550,59.2,651,stable,39.9,441,701982,0,0
FL,"Leon County, Florida",60286,28018,32268,12073,46745,115325,17626,131496,15063,246821,32689,54.8,130,stable,42,98,286272,0,0
FL,"Levy County, Florida",8601,4159,4442,12075,35782,15211,4276,16052,3841,31263,8117,103.5,67,stable,77.3,49,39832,0,0
FL,"Liberty County, Florida",1237,711,526,12077,39406,2740,935,2544,555,5284,1490,73.3,6,stable,84.1,7,8331,0,0
FL,"Madison County, Florida",4269,1989,2280,12079,32164,6335,1640,7137,1571,13472,3211,54.8,14,stable,55,14,18408,0,0
FL,"Manatee County, Florida",51595,23144,28451,12081,49675,133634,30738,149647,26970,283281,57708,59,328,stable,41.7,236,363369,0,0
FL,"Marion County, Florida",60207,26829,33378,12083,39459,128783,29261,144671,26132,273454,55393,82,493,falling,56.6,347,343254,0,1
FL,"Martin County, Florida",17965,8725,9240,12085,51593,60203,12641,67195,8716,127398,21357,59.6,177,stable,40.5,124,156283,0,0
FL,"Miami-Dade County, Florida",530006,234079,295927,12086,43129,913720,345984,1029301,323198,1943021,669182,44.4,1310,stable,29.9,885,2693117,0,0
FL,"Monroe County, Florida",9998,4952,5046,12087,57290,29681,9093,27902,7520,57583,16613,54.6,62,stable,45.5,50,77482,0,0
FL,"Nassau County, Florida",9652,4524,5128,12089,54116,30711,6234,33052,5141,63763,11375,81.2,83,stable,57.3,57,78444,0,0
FL,"Okaloosa County, Florida",24595,11057,13538,12091,55880,73497,13973,81113,12515,154610,26488,71.8,153,stable,57.1,121,198664,0,0
FL,"Okeechobee County, Florida",9965,4747,5218,12093,35405,13706,4583,14278,3667,27984,8250,93.3,48,stable,69.3,36,39469,0,0
FL,"Orange County, Florida",212489,96829,115660,12095,47943,467393,128157,507628,114016,975021,242173,57.6,588,stable,42.1,424,1288126,0,0
FL,"Osceola County, Florida",58146,26746,31400,12097,44254,112065,34689,121293,30788,233358,65477,54.7,147,stable,38.1,102,323993,0,0
FL,"Palm Beach County, Florida",197340,88523,108817,12099,53363,529441,128224,596926,111457,1126367,239681,54.1,1183,stable,37.3,852,1422789,0,0
FL,"Pasco County, Florida",66144,29154,36990,12101,45064,193843,35107,212253,32228,406096,67335,75.9,552,stable,57.3,422,497909,0,0
FL,"Pinellas County, Florida",131643,58929,72714,12103,45819,365646,75277,414317,64993,779963,140270,68.9,1032,stable,50.6,777,949827,0,0
FL,"Polk County, Florida",111877,50847,61030,12105,43162,244527,54900,269368,48305,513895,103205,74.4,631,falling,50.1,423,650092,0,1
FL,"Putnam County, Florida",20397,9041,11356,12107,31715,26738,8046,29921,6747,56659,14793,97.2,106,stable,71.1,78,72023,0,0
FL,"St. Johns County, Florida",19706,8625,11081,12109,66194,89166,11914,97157,10407,186323,22321,65.2,166,stable,42.3,107,226640,0,0
FL,"St. Lucie County, Florida",52201,24225,27976,12111,43459,111403,27579,121141,25709,232544,53288,64.5,277,stable,48.9,213,298563,0,0
FL,"Santa Rosa County, Florida",19063,8482,10581,12113,58923,63955,10401,68241,9510,132196,19911,74.9,130,stable,61.6,104,167040,0,0
FL,"Sarasota County, Florida",42386,19475,22911,12115,51766,156083,29291,177734,25125,333817,54416,57.6,479,stable,41.9,366,405549,0,0
FL,"Seminole County, Florida",52637,24575,28062,12117,57010,175304,34653,193878,30781,369182,65434,54.2,246,falling,41.5,187,449144,0,1
FL,"Sumter County, Florida",10802,4602,6200,12119,50350,42824,4040,47895,4641,90719,8681,65.3,180,falling,43.1,110,118891,0,1
FL,"Suwannee County, Florida",10012,4500,5512,12121,36289,16064,4338,18457,3256,34521,7594,87.2,53,stable,67.9,42,43760,0,0
FL,"Taylor County, Florida",2720,1226,1494,12123,36181,7353,1417,8621,1209,15974,2626,84.4,25,stable,66.8,20,22493,0,0
FL,"Union County, Florida",2002,814,1188,12125,39163,4013,645,4612,749,8625,1394,203.7,35,stable,113.5,19,15234,0,0
FL,"Volusia County, Florida",85881,39086,46795,12127,41117,195665,46346,218308,37655,413973,84001,70.8,568,stable,54.1,439,517887,0,0
FL,"Wakulla County, Florida",4101,1658,2443,12129,50340,11867,1904,12202,1544,24069,3448,95.9,31,stable,76.3,24,31535,0,0
FL,"Walton County, Florida",9804,5087,4717,12131,44966,22001,6235,24485,4684,46486,10919,74.3,57,stable,54.4,41,63508,0,0
FL,"Washington County, Florida",4723,2407,2316,12133,38970,9143,1767,9808,1333,18951,3100,74.7,23,stable,67.5,21,24687,0,0
GA,"Appling County, Georgia",3745,1485,2260,13001,37135,6884,1813,7352,1904,14236,3717,74.4,15,stable,56.3,12,18454,0,0
GA,"Atkinson County, Georgia",2370,1068,1302,13003,30933,2825,1239,2946,1258,5771,2497,59.4,5,stable,75.8,6,8398,0,0
GA,"Bacon County, Georgia",1919,850,1069,13005,37162,4042,1127,4639,893,8681,2020,87.5,11,stable,66.5,8,11299,0,0
GA,"Baldwin County, Georgia",13201,5601,7600,13009,32460,17553,3212,20229,2532,37782,5744,73.5,36,stable,47.3,23,45459,0,0
GA,"Banks County, Georgia",3026,1497,1529,13011,41472,7764,1546,7383,1626,15147,3172,65.2,13,stable,33.8,7,18495,0,0
GA,"Barrow County, Georgia",10902,5099,5803,13013,52012,29308,6640,29988,5862,59296,12502,89.6,55,stable,63.4,37,75370,0,0
GA,"Bartow County, Georgia",15819,6659,9160,13015,48893,40864,8691,42129,8803,82993,17494,91.3,91,stable,63.2,61,102747,0,0
GA,"Ben Hill County, Georgia",6024,2511,3513,13017,29994,6364,1800,7307,1686,13671,3486,84,18,stable,65.1,13,17403,0,0
GA,"Berrien County, Georgia",4923,2088,2835,13019,31835,6868,2398,7046,2399,13914,4797,78.2,18,stable,54.4,12,18963,0,0
GA,"Bibb County, Georgia",40611,16798,23813,13021,36519,57314,12905,68408,12534,125722,25439,79.4,134,stable,59.1,99,153721,0,0
GA,"Bleckley County, Georgia",2616,1270,1346,13023,38991,5107,829,5784,661,10891,1490,72.3,11,stable,60.1,9,12243,0,0
GA,"Brantley County, Georgia",3812,1561,2251,13025,37206,6714,2402,6844,2433,13558,4835,87.8,18,stable,74.1,15,18455,0,0
GA,"Brooks County, Georgia",4265,1864,2401,13027,32663,5831,1825,6442,1500,12273,3325,76.9,16,stable,51.1,11,15658,0,0
GA,"Bryan County, Georgia",4487,1939,2548,13029,63327,13252,2139,14659,2148,27911,4287,84.3,22,stable,68.1,17,35137,0,0
GA,"Bulloch County, Georgia",21794,10148,11646,13031,36032,29523,5724,30317,5977,59840,11701,78.6,44,stable,56.8,32,72651,0,0
GA,"Burke County, Georgia",7131,3099,4032,13033,33641,8811,2074,9966,1911,18777,3985,85.9,21,stable,51.6,13,22745,0,0
GA,"Butts County, Georgia",4329,2023,2306,13035,41667,8376,1778,9064,1781,17440,3559,95.7,25,stable,81.3,20,23593,0,0
GA,"Calhoun County, Georgia",1924,891,1033,13037,25513,1590,514,2045,524,3635,1038,63.4,4,stable,50.2,4,6479,0,0
GA,"Camden County, Georgia",6365,2795,3570,13039,52473,19948,3210,21611,3033,41559,6243,67.4,29,stable,49.3,21,52102,0,0
GA,"Candler County, Georgia",3398,1480,1918,13043,30185,3697,1481,4227,1339,7924,2820,82.9,11,stable,62.1,8,10886,0,0
GA,"Carroll County, Georgia",22441,9360,13081,13045,43586,44101,9868,48004,9459,92105,19327,83.9,88,stable,59,62,114545,0,0
GA,"Catoosa County, Georgia",8061,3588,4473,13047,50876,26625,4978,29051,4201,55676,9179,65.6,50,stable,49.1,37,66050,0,0
GA,"Charlton County, Georgia",2010,1140,870,13049,42778,4584,1208,4690,1299,9274,2507,60,9,stable,49.4,7,12965,0,0
GA,"Chatham County, Georgia",50980,21510,29470,13051,47218,104174,23951,119106,24088,223280,48039,65.2,183,stable,44.4,126,286956,0,0
GA,"Chattooga County, Georgia",5488,2243,3245,13055,32913,9063,2149,10018,2139,19081,4288,101.5,31,stable,74.5,23,24922,0,0
GA,"Cherokee County, Georgia",24273,11323,12950,13057,68926,93307,17236,99818,14680,193125,31916,73.2,135,stable,46.7,84,235900,0,0
GA,"Clarke County, Georgia",40559,18801,21758,13059,32162,46322,10381,53847,9368,100169,19749,61.8,52,stable,41.6,36,123912,0,0
GA,"Clayton County, Georgia",65787,29093,36694,13063,40938,91148,33348,106904,32596,198052,65944,65.1,115,falling,45.5,79,273955,0,1
GA,"Clinch County, Georgia",2339,915,1424,13065,24015,2631,644,2665,720,5296,1364,86.9,7,stable,56,4,6893,0,0
GA,"Cobb County, Georgia",87880,40060,47820,13067,65873,283287,61679,312433,56631,595720,118310,60.3,341,falling,40.3,223,741334,0,1
GA,"Coffee County, Georgia",9975,4089,5886,13069,33965,14017,4585,16269,4704,30286,9289,79.5,34,stable,59.9,25,43108,0,0
GA,"Colquitt County, Georgia",12086,5622,6464,13071,32409,15045,7292,17560,5434,32605,12726,89.5,44,stable,62,30,45844,0,0
GA,"Columbia County, Georgia",12517,5247,7270,13073,71021,57173,6985,62660,6391,119833,13376,61.4,73,stable,43.8,53,144052,0,0
GA,"Cook County, Georgia",4244,1837,2407,13075,35683,6130,2021,6425,2313,12555,4334,90,17,stable,60.5,12,17124,0,0
GA,"Coweta County, Georgia",17489,7061,10428,13077,62461,56787,8063,60351,7622,117138,15685,65,78,stable,47.4,57,138427,0,0
GA,"Crawford County, Georgia",2122,984,1138,13079,41825,5257,1072,5226,836,10483,1908,100.7,16,stable,65.9,9,12388,0,0
GA,"Crisp County, Georgia",7468,3161,4307,13081,31615,8719,1980,9882,2284,18601,4264,72.3,21,stable,59.2,17,22881,0,0
GA,"Dade County, Georgia",2300,986,1314,13083,46434,6555,1335,7142,1264,13697,2599,79.7,17,stable,79.3,16,16264,0,0
GA,"Dawson County, Georgia",3156,1372,1784,13085,56943,9301,1797,9935,1457,19236,3254,74.1,21,stable,61.8,16,23312,0,0
GA,"Decatur County, Georgia",7418,3071,4347,13087,31284,9471,2732,11253,2606,20724,5338,70.4,23,stable,58.2,19,27174,0,0
GA,"DeKalb County, Georgia",135469,61067,74402,13089,51376,266420,70503,307491,64529,573911,135032,53.2,311,falling,37.8,216,734871,0,1
GA,"Dodge County, Georgia",4279,2065,2214,13091,34271,7503,1809,8548,1351,16051,3160,81.3,20,stable,53.6,13,20882,0,0
GA,"Dooly County, Georgia",3673,1729,1944,13093,28696,4541,1544,5394,1140,9935,2684,58.6,10,stable,29.8,5,14035,0,0
GA,"Dougherty County, Georgia",27557,11753,15804,13095,32084,32319,9804,40211,9197,72530,19001,73.4,72,stable,60.9,59,91332,0,0
GA,"Douglas County, Georgia",22118,9856,12262,13097,53881,53134,11539,59541,11129,112675,22668,81.1,90,stable,55,59,140733,0,0
GA,"Early County, Georgia",2916,1293,1623,13099,31680,3871,934,4701,914,8572,1848,61.5,9,stable,60.1,8,10575,0,0
GA,"Effingham County, Georgia",5749,2473,3276,13103,63100,22974,3773,22833,4476,45807,8249,85.2,41,stable,65.8,29,57106,0,0
GA,"Elbert County, Georgia",3664,1459,2205,13105,35388,7653,1521,8694,1435,16347,2956,73.4,20,stable,56,15,19364,0,0
GA,"Emanuel County, Georgia",6700,3151,3549,13107,32229,7750,2841,9203,2169,16953,5010,67.6,18,stable,59.3,16,22708,0,0
GA,"Evans County, Georgia",2857,1127,1730,13109,37865,3903,817,4597,1013,8500,1830,68.8,9,stable,54.8,7,10787,0,0
GA,"Fannin County, Georgia",5404,2047,3357,13111,37049,9310,2140,10093,2040,19403,4180,73.2,29,stable,46.6,20,24303,0,0
GA,"Fayette County, Georgia",9129,3883,5246,13113,79066,47425,4750,50925,4698,98350,9448,47.4,57,stable,34.1,40,110714,0,0
GA,"Floyd County, Georgia",19605,9048,10557,13115,41549,36663,8536,40916,7882,77579,16418,81.1,92,stable,55.5,63,96504,0,0
GA,"Forsyth County, Georgia",13547,5932,7615,13117,88816,85640,11472,87649,10870,173289,22342,60.6,90,stable,35,51,212438,0,0
GA,"Franklin County, Georgia",5122,2253,2869,13119,33816,8671,2036,9360,1836,18031,3872,81.4,25,stable,64.5,19,22311,0,0
GA,"Fulton County, Georgia",167391,72577,94814,13121,57207,395438,75916,432816,71007,828254,146923,54.5,431,falling,38.3,298,1010562,0,1
GA,"Gilmer County, Georgia",6664,3541,3123,13123,40228,10809,3588,11237,2791,22046,6379,76.1,32,stable,39.1,16,29400,0,0
GA,"Glynn County, Georgia",14981,6339,8642,13127,45918,30774,7351,35063,7594,65837,14945,71.9,73,stable,50.9,51,83579,0,0
GA,"Gordon County, Georgia",11188,5321,5867,13129,41612,21972,5414,22625,5339,44597,10753,94.7,55,stable,74.1,43,56574,0,0
GA,"Grady County, Georgia",7648,3529,4119,13131,34187,9315,3037,9964,2735,19279,5772,74,23,stable,64.5,19,25205,0,0
GA,"Greene County, Georgia",4033,1870,2163,13133,42408,6205,1667,6972,1310,13177,2977,69.9,19,stable,37.3,10,16710,0,0
GA,"Gwinnett County, Georgia",117553,54558,62995,13135,60289,330105,87272,355186,81567,685291,168839,51.8,288,falling,37.3,200,895823,0,1
GA,"Habersham County, Georgia",7220,3357,3863,13137,40907,16605,3957,16796,3866,33401,7823,64.4,35,stable,49.3,27,43996,0,0
GA,"Hall County, Georgia",34120,16393,17727,13139,51202,73737,19196,76493,17175,150230,36371,61.2,108,stable,45.6,81,193535,0,0
GA,"Hancock County, Georgia",2113,835,1278,13141,24925,2620,447,3321,625,5941,1072,38.8,5,stable,41.6,5,8551,0,0
GA,"Haralson County, Georgia",5724,2583,3141,13143,41910,11440,2323,12250,2189,23690,4512,94.4,33,falling,76,26,28854,0,1
GA,"Harris County, Georgia",2991,1317,1674,13145,63824,13962,1999,14769,1625,28731,3624,62,24,stable,45.8,17,33381,0,0
GA,"Hart County, Georgia",5403,2421,2982,13147,37653,9591,2477,10690,1905,20281,4382,69,25,stable,51.1,19,25534,0,0
GA,"Heard County, Georgia",2349,1048,1301,13149,41525,4696,946,4900,932,9596,1878,104.6,15,stable,64.6,9,11539,0,0
GA,"Henry County, Georgia",27162,11870,15292,13151,60424,85371,14877,94784,15133,180155,30010,60.3,102,stable,46.7,74,217739,0,0
GA,"Houston County, Georgia",25111,10623,14488,13153,53270,58947,10117,65869,9306,124816,19423,73.2,96,stable,56.4,72,150033,0,0
GA,"Irwin County, Georgia",2300,1081,1219,13155,34156,3483,913,3663,807,7146,1720,83.4,10,stable,68.5,8,9245,0,0
GA,"Jackson County, Georgia",8314,3770,4544,13157,53379,25164,4923,26283,4530,51447,9453,78.4,50,stable,62.1,37,63360,0,0
GA,"Jasper County, Georgia",2785,1269,1516,13159,42368,5250,1356,5831,1056,11081,2412,78.7,12,stable,45.2,7,13635,0,0
GA,"Jeff Davis County, Georgia",3309,1383,1926,13161,36385,5847,1475,5753,1799,11600,3274,76.2,13,stable,74.9,13,14920,0,0
GA,"Jefferson County, Georgia",4889,2228,2661,13163,26557,5460,2074,6623,1709,12083,3783,62.8,14,stable,68.8,14,16106,0,0
GA,"Jenkins County, Georgia",2984,1335,1649,13165,24604,3388,1032,3609,811,6997,1843,68.6,7,stable,60,6,8957,0,0
GA,"Johnson County, Georgia",2125,1064,1061,13167,34438,4053,936,3524,722,7577,1658,65.4,8,stable,53.9,7,9656,0,0
GA,"Jones County, Georgia",4770,2119,2651,13169,51857,11697,2189,12775,1798,24472,3987,79.9,27,stable,56.7,18,28494,0,0
GA,"Lamar County, Georgia",3713,1794,1919,13171,40344,6918,1516,7795,1609,14713,3125,86.5,18,stable,70.7,15,18201,0,0
GA,"Lanier County, Georgia",2675,1226,1449,13173,37605,3545,1171,4178,968,7723,2139,77.2,8,stable,63.3,6,10312,0,0
GA,"Laurens County, Georgia",12823,5604,7219,13175,32356,18632,3499,21023,3685,39655,7184,69.5,41,stable,54.6,32,47731,0,0
GA,"Lee County, Georgia",3417,1356,2061,13177,61537,11578,1659,12983,1398,24561,3057,83.2,19,stable,62.2,14,29202,0,0
GA,"Liberty County, Georgia",11047,4963,6084,13179,42201,22886,4140,27203,3953,50089,8093,76.8,30,stable,46.7,18,62467,0,0
GA,"Lincoln County, Georgia",1912,799,1113,13181,34243,3005,613,3339,676,6344,1289,65.3,7,stable,54.5,6,7673,0,0
GA,"Long County, Georgia",2936,1244,1692,13183,48863,5944,1405,7095,1139,13039,2544,88.9,10,stable,60.6,7,17731,0,0
GA,"Lowndes County, Georgia",28907,13270,15637,13185,36834,40735,10962,46699,10123,87434,21085,65.3,62,stable,52.8,49,112865,0,0
GA,"Lumpkin County, Georgia",5559,2398,3161,13187,43804,12100,2752,13756,1907,25856,4659,72.3,24,stable,50,16,31408,0,0
GA,"McDuffie County, Georgia",5410,2397,3013,13189,36656,8135,1936,9121,2099,17256,4035,69.5,18,stable,57.6,14,21540,0,0
GA,"McIntosh County, Georgia",2956,1296,1660,13191,42988,5469,1281,6025,1132,11494,2413,55,11,stable,39.5,8,13969,0,0
GA,"Macon County, Georgia",3639,1541,2098,13193,28684,4552,1488,5046,1199,9598,2687,69,11,stable,55.9,9,13632,0,0
GA,"Madison County, Georgia",4798,2176,2622,13195,41912,11295,2515,12103,2143,23398,4658,90.4,31,stable,70.8,23,28441,0,0
GA,"Marion County, Georgia",1836,640,1196,13197,36242,3072,1249,3655,663,6727,1912,64.6,7,falling,56.7,6,8761,0,1
GA,"Meriwether County, Georgia",4733,2135,2598,13199,35832,8287,1832,9123,1925,17410,3757,66.8,19,stable,54,15,21190,0,0
GA,"Miller County, Georgia",1608,648,960,13201,33983,2210,518,2575,471,4785,989,89.1,8,stable,64.8,6,5854,0,0
GA,"Mitchell County, Georgia",5905,2385,3520,13205,31915,7804,2078,8547,2342,16351,4420,85.1,23,stable,56.2,15,22574,0,0
GA,"Monroe County, Georgia",3492,1480,2012,13207,48744,10708,1782,11425,1731,22133,3513,72.7,24,stable,41,13,27103,0,0
GA,"Montgomery County, Georgia",2076,979,1097,13209,34672,3344,832,3630,785,6974,1617,71.7,7,stable,66.8,6,8951,0,0
GA,"Morgan County, Georgia",2529,1047,1482,13211,51820,7275,1122,7953,1354,15228,2476,65.5,16,stable,49.2,11,18046,0,0
GA,"Murray County, Georgia",7765,3685,4080,13213,35539,14877,4265,16243,3793,31120,8058,103.1,42,stable,69.7,28,39565,0,0
GA,"Muscogee County, Georgia",38921,16697,22224,13215,42306,71343,14830,87018,13855,158361,28685,70.3,134,stable,51.7,99,200579,0,0
GA,"Newton County, Georgia",17281,7478,9803,13217,49179,40481,7653,45244,8348,85725,16001,78.9,69,stable,59.5,51,105473,0,0
GA,"Oconee County, Georgia",2487,1084,1403,13219,72182,14971,1716,15812,1701,30783,3417,46.8,15,stable,34.3,11,35965,0,0
GA,"Oglethorpe County, Georgia",2316,1054,1262,13221,44226,6078,1142,6369,957,12447,2099,75.4,14,stable,44.5,8,14871,0,0
GA,"Paulding County, Georgia",18445,7439,11006,13223,60109,61605,10000,65284,9849,126889,19849,77.7,83,stable,51.9,51,152238,0,0
GA,"Peach County, Georgia",5471,2439,3032,13225,41588,10354,2667,11558,2377,21912,5044,77.9,22,stable,71.9,20,26720,0,0
GA,"Pickens County, Georgia",3418,1479,1939,13227,54123,12454,2293,12939,1782,25393,4075,82.3,34,stable,54,22,30309,0,0
GA,"Pierce County, Georgia",4455,2269,2186,13229,40247,7350,1945,7718,1777,15068,3722,80.1,18,stable,70.5,16,19103,0,0
GA,"Pike County, Georgia",2132,1008,1124,13231,51338,7234,1444,7439,1428,14673,2872,75.6,15,stable,62.9,12,17941,0,0
GA,"Polk County, Georgia",8767,3831,4936,13233,37853,15636,4410,17711,3149,33347,7559,102,48,stable,77.5,37,41524,0,0
GA,"Pulaski County, Georgia",1929,655,1274,13235,38750,3916,858,4421,852,8337,1710,50.6,8,stable,37.8,6,11396,0,0
GA,"Putnam County, Georgia",3446,1912,1534,13237,44299,8179,2278,9375,1249,17554,3527,74.4,23,stable,55.9,17,21353,0,0
GA,"Quitman County, Georgia",558,208,350,13239,31487,855,251,1046,174,1901,425,110.8,5,stable,87.2,4,2302,0,0
GA,"Rabun County, Georgia",3458,1544,1914,13241,35211,5685,2167,6431,1784,12116,3951,67.1,18,stable,46.3,13,16281,0,0
GA,"Randolph County, Georgia",2145,1079,1066,13243,28377,2791,888,2898,620,5689,1508,56.6,6,stable,40.9,5,7193,0,0
GA,"Richmond County, Georgia",48498,20943,27555,13245,37424,73605,15946,86184,15914,159789,31860,72.7,148,falling,56.8,113,201793,0,1
GA,"Rockdale County, Georgia",14155,6535,7620,13247,50455,32871,7965,36981,8361,69852,16326,60.7,49,stable,40.3,32,88856,0,0
GA,"Screven County, Georgia",3482,1551,1931,13251,34466,5274,1358,5852,1327,11126,2685,79.1,15,stable,57,10,14162,0,0
GA,"Seminole County, Georgia",1595,594,1001,13253,34905,3165,893,3756,849,6921,1742,66.4,9,stable,38.8,5,8647,0,0
GA,"Spalding County, Georgia",14238,5975,8263,13255,40246,24186,5838,28153,4617,52339,10455,74.3,55,stable,52.2,38,64051,0,0
GA,"Stephens County, Georgia",4707,2468,2239,13257,40315,10161,2186,11520,1748,21681,3934,76.8,27,stable,63.1,22,25586,0,0
GA,"Stewart County, Georgia",1645,693,952,13259,21118,1401,648,1860,389,3261,1037,65.5,4,stable,65,4,5851,0,0
GA,"Sumter County, Georgia",9741,4124,5617,13261,32758,11738,2388,13950,2450,25688,4838,63.1,22,stable,48.6,17,30779,0,0
GA,"Talbot County, Georgia",1291,630,661,13263,34078,2635,485,2787,563,5422,1048,73.2,7,stable,61.4,5,6337,0,0
GA,"Tattnall County, Georgia",5646,2173,3473,13267,33980,7168,1613,8696,1947,15864,3560,100.8,26,stable,79.1,20,25229,0,0
GA,"Taylor County, Georgia",2351,1041,1310,13269,28143,2958,903,3593,739,6551,1642,54.2,6,stable,43.1,5,8330,0,0
GA,"Telfair County, Georgia",3565,1401,2164,13271,26449,4484,1276,5636,1127,10120,2403,55.1,11,stable,45.6,9,16400,0,0
GA,"Terrell County, Georgia",3216,1329,1887,13273,28688,3138,942,3922,881,7060,1823,63,8,stable,53.7,6,9113,0,0
GA,"Thomas County, Georgia",10335,4943,5392,13275,36641,16665,4194,19432,3831,36097,8025,74.5,41,stable,60.6,34,45063,0,0
GA,"Tift County, Georgia",11372,4841,6531,13277,37653,14468,4956,16409,4533,30877,9489,71.4,31,stable,54.1,23,40764,0,0
GA,"Toombs County, Georgia",6674,2769,3905,13279,33679,9405,3180,11303,2984,20708,6164,74,23,stable,58.6,18,27241,0,0
GA,"Towns County, Georgia",1862,817,1045,13281,37000,4375,762,4735,764,9110,1526,62.4,15,stable,56.5,12,11182,0,0
GA,"Treutlen County, Georgia",1242,491,751,13283,38596,2427,519,2918,501,5345,1020,78.5,6,stable,61,5,6785,0,0
GA,"Troup County, Georgia",14388,5631,8757,13285,41489,26673,5391,30199,5172,56872,10563,71.1,52,stable,50.6,37,69763,0,0
GA,"Turner County, Georgia",2027,1067,960,13287,31806,2846,1128,3240,770,6086,1898,80.4,9,stable,54.9,6,8214,0,0
GA,"Twiggs County, Georgia",2324,976,1348,13289,30468,3447,682,3660,630,7107,1312,91.8,12,stable,57.2,7,8390,0,0
GA,"Union County, Georgia",2860,1353,1507,13291,40799,8616,1695,9628,1331,18244,3026,70.4,30,stable,43.5,18,22267,0,0
GA,"Upson County, Georgia",6137,2988,3149,13293,35774,10356,1973,11483,2142,21839,4115,87.8,31,stable,56.5,20,26368,0,0
GA,"Walker County, Georgia",11818,5435,6383,13295,41632,27895,4896,28522,5676,56417,10572,84.3,72,stable,76.4,65,68066,0,0
GA,"Walton County, Georgia",11801,4642,7159,13297,54453,36422,5187,37677,6185,74099,11372,67.9,61,stable,53.5,47,88399,0,0
GA,"Ware County, Georgia",9686,3807,5879,13299,34909,12488,3237,14200,3448,26688,6685,70.6,32,stable,50.6,22,35370,0,0
GA,"Warren County, Georgia",1485,619,866,13301,29176,2094,438,2470,481,4564,919,84.9,7,stable,70.4,6,5460,0,0
GA,"Washington County, Georgia",4961,2052,2909,13303,37932,7449,1569,8563,1594,16012,3163,68.2,17,stable,49.4,12,20816,0,0
GA,"Wayne County, Georgia",5633,2316,3317,13305,38955,10408,3006,11328,3135,21736,6141,76.2,25,stable,59.3,19,29534,0,0
GA,"Wheeler County, Georgia",1177,404,773,13309,27620,1508,335,1962,544,3470,879,62.8,5,stable,51.2,4,7903,0,0
GA,"White County, Georgia",5195,2364,2831,13311,40888,11160,2236,11932,2264,23092,4500,69.8,27,stable,47.3,17,28319,0,0
GA,"Whitfield County, Georgia",19270,8532,10738,13313,40596,39089,11898,40821,10887,79910,22785,77.6,79,stable,64.5,64,104216,0,0
GA,"Wilcox County, Georgia",1599,675,924,13315,32043,2808,532,3002,597,5810,1129,64.9,7,stable,45.7,5,8857,0,0
GA,"Wilkes County, Georgia",2795,1122,1673,13317,32727,3817,797,4416,788,8233,1585,66,10,stable,57.7,9,9867,0,0
GA,"Wilkinson County, Georgia",1640,661,979,13319,38485,3862,674,4275,476,8137,1150,79.9,11,stable,56.9,8,9155,0,0
GA,"Worth County, Georgia",4445,1961,2484,13321,37974,7876,2283,8636,2197,16512,4480,70.8,19,stable,51.3,13,20699,0,0
HI,"Hawaii County, Hawaii",36756,17957,18799,15001,52108,86553,8577,88674,6523,175227,15100,44.9,107,stable,33.3,79,196428,0,0
HI,"Honolulu County, Hawaii",92404,41559,50845,15003,74460,429201,26111,457423,20975,886624,47086,48.3,550,stable,32.9,377,998714,0,0
HI,"Kauai County, Hawaii",7384,3291,4093,15007,65101,31135,3317,32223,2228,63358,5545,45.2,39,stable,34.6,30,71735,0,0
HI,"Maui County, Hawaii",17388,7899,9489,15009,66476,72806,6977,74047,5505,146853,12482,43.2,80,stable,28.6,51,164637,0,0
IA,"Adair County, Iowa",764,274,490,19001,46526,3329,296,3429,233,6758,529,65.2,8,stable,42.3,5,7228,0,0
IA,"Allamakee County, Iowa",1491,620,871,19005,45890,6267,742,6077,667,12344,1409,39.9,9,stable,35.3,8,13886,0,0
IA,"Appanoose County, Iowa",1719,749,970,19007,41394,5533,706,5627,672,11160,1378,78.5,15,rising,56.3,11,12529,1,0
IA,"Benton County, Iowa",2440,1215,1225,19011,60606,12198,616,12243,509,24441,1125,67.5,22,stable,50.2,17,25658,0,0
IA,"Black Hawk County, Iowa",19887,8889,10998,19013,48369,59036,5024,62677,4475,121713,9499,72.5,108,stable,56.3,84,133455,0,0
IA,"Boone County, Iowa",2588,1093,1495,19015,52985,11723,1177,12144,725,23867,1902,61.3,21,stable,47.4,17,26643,0,0
IA,"Bremer County, Iowa",1894,671,1223,19017,62163,11386,568,11904,318,23290,886,41.6,14,stable,31.7,10,24722,0,0
IA,"Buchanan County, Iowa",1970,843,1127,19019,56150,9284,996,9578,887,18862,1883,82.8,21,stable,56.2,15,21062,0,0
IA,"Buena Vista County, Iowa",2452,1068,1384,19021,48195,9022,1388,8938,886,17960,2274,40.9,10,stable,28.4,7,20493,0,0
IA,"Butler County, Iowa",1322,533,789,19023,52360,6876,437,6901,491,13777,928,45.4,10,stable,35.4,8,14915,0,0
IA,"Calhoun County, Iowa",1384,658,726,19025,44921,4349,298,4471,263,8820,561,54.6,9,stable,40.4,7,9818,0,0
IA,"Carroll County, Iowa",2047,675,1372,19027,50559,9502,392,9945,427,19447,819,60.8,18,stable,44.4,14,20498,0,0
IA,"Cass County, Iowa",1855,888,967,19029,43750,6042,505,6474,308,12516,813,73.2,15,stable,57.1,12,13427,0,0
IA,"Cedar County, Iowa",1393,615,778,19031,59047,8437,466,8851,379,17288,845,66.5,16,stable,40.6,10,18340,0,0
IA,"Cerro Gordo County, Iowa",5665,2333,3332,19033,46122,19432,1546,20426,1418,39858,2964,65.8,43,stable,41.7,27,43017,0,0
IA,"Cherokee County, Iowa",1281,565,716,19035,48599,5309,509,5252,390,10561,899,47.6,10,stable,36.3,8,11574,0,0
IA,"Chickasaw County, Iowa",1067,493,574,19037,47040,5706,396,5630,384,11336,780,52.9,10,stable,44,8,12097,0,0
IA,"Clarke County, Iowa",1493,658,835,19039,43327,3958,680,4065,439,8023,1119,70.6,9,rising,58.4,7,9259,1,0
IA,"Clay County, Iowa",1848,727,1121,19041,50389,7388,616,7707,544,15095,1160,57.8,13,stable,41.5,10,16507,0,0
IA,"Clayton County, Iowa",1941,799,1142,19043,48007,8115,684,8114,656,16229,1340,60.3,16,stable,37.1,10,17644,0,0
IA,"Clinton County, Iowa",6608,2840,3768,19045,50498,21990,1640,22956,1284,44946,2924,64.1,42,stable,50.5,33,47768,0,0
IA,"Crawford County, Iowa",3367,1594,1773,19047,48084,7484,1129,7631,807,15115,1936,54.8,12,stable,33.6,8,17094,0,0
IA,"Dallas County, Iowa",4796,2038,2758,19049,76320,34604,2002,36040,1736,70644,3738,61.6,38,stable,36.7,22,80133,0,0
IA,"Davis County, Iowa",1657,662,995,19051,48888,3242,1023,3150,1212,6392,2235,53.6,6,stable,36.9,4,8769,0,0
IA,"Decatur County, Iowa",1541,722,819,19053,38560,3601,468,3449,622,7050,1090,65,7,stable,40.5,5,8220,0,0
IA,"Delaware County, Iowa",1717,855,862,19055,58274,8234,452,8359,297,16593,749,38.4,9,stable,25.7,6,17403,0,0
IA,"Des Moines County, Iowa",6010,2095,3915,19057,44423,17543,1763,19146,1255,36689,3018,86.7,49,stable,58.6,33,40055,0,0
IA,"Dickinson County, Iowa",1100,433,667,19059,57265,7864,524,7901,469,15765,993,59.6,18,stable,41.3,12,17111,0,0
IA,"Dubuque County, Iowa",11189,4826,6363,19061,54605,44017,2826,45546,2267,89563,5093,59.4,70,falling,46.7,56,97125,0,1
IA,"Emmet County, Iowa",1250,524,726,19063,47795,4217,614,4425,389,8642,1003,69.8,10,stable,45.3,7,9769,0,0
IA,"Fayette County, Iowa",2550,1189,1361,19065,44928,9182,997,9220,835,18402,1832,59.9,19,stable,40.2,13,20257,0,0
IA,"Floyd County, Iowa",1957,836,1121,19067,44797,7168,721,7339,613,14507,1334,65.7,16,stable,55.1,13,15960,0,0
IA,"Franklin County, Iowa",1372,651,721,19069,48605,4792,399,4761,384,9553,783,54.7,8,rising,45.3,7,10295,1,0
IA,"Fremont County, Iowa",757,372,385,19071,53324,3162,317,3270,234,6432,551,76.2,8,stable,63,7,6906,0,0
IA,"Greene County, Iowa",1135,460,675,19073,46898,4174,252,4412,221,8586,473,63.7,9,rising,56.4,8,9027,1,0
IA,"Grundy County, Iowa",757,288,469,19075,56750,5728,300,6002,225,11730,525,48.7,9,stable,33.5,6,12435,0,0
IA,"Guthrie County, Iowa",1199,515,684,19077,51013,4793,474,4992,343,9785,817,55.6,9,stable,51.9,9,10676,0,0
IA,"Hamilton County, Iowa",1712,700,1012,19079,49813,6519,842,7204,528,13723,1370,64.7,14,stable,41,9,15190,0,0
IA,"Hancock County, Iowa",924,413,511,19081,52981,5254,289,5137,260,10391,549,58.8,9,stable,47.4,8,10974,0,0
IA,"Hardin County, Iowa",1454,584,870,19083,51019,7755,617,7942,535,15697,1152,58.5,16,stable,46.9,13,17367,0,0
IA,"Harrison County, Iowa",1398,633,765,19085,53567,6389,699,6658,472,13047,1171,86.4,18,stable,48.3,10,14265,0,0
IA,"Henry County, Iowa",2695,1303,1392,19087,49321,8589,702,8945,648,17534,1350,70.4,18,stable,51.5,13,19950,0,0
IA,"Howard County, Iowa",1081,472,609,19089,49869,4305,326,4313,376,8618,702,41.9,6,stable,35.7,5,9410,0,0
IA,"Humboldt County, Iowa",1155,447,708,19091,47252,4394,301,4616,246,9010,547,54.5,9,stable,31,5,9555,0,0
IA,"Ida County, Iowa",809,395,414,19093,46993,3226,300,3149,267,6375,567,55.6,6,stable,41.7,5,7028,0,0
IA,"Iowa County, Iowa",1391,615,776,19095,59375,7475,521,7678,421,15153,942,47.5,11,stable,40.6,9,16401,0,0
IA,"Jackson County, Iowa",2343,899,1444,19097,49028,8854,774,8959,794,17813,1568,66.1,18,stable,53.8,15,19444,0,0
IA,"Jasper County, Iowa",3342,1456,1886,19099,55033,15903,1312,16644,1164,32547,2476,72.4,36,stable,53.8,27,36827,0,0
IA,"Jefferson County, Iowa",2311,1294,1017,19101,42899,7808,1132,7504,729,15312,1861,49.5,11,stable,34.6,7,17555,0,0
IA,"Johnson County, Iowa",23537,11609,11928,19103,55700,62291,5726,65282,4449,127573,10175,50.5,53,stable,36.7,37,144251,0,0
IA,"Jones County, Iowa",1950,828,1122,19105,55060,8896,559,9288,493,18184,1052,57.8,17,stable,36.6,11,20466,0,0
IA,"Keokuk County, Iowa",1374,613,761,19107,43838,4763,393,4784,228,9547,621,68.1,10,stable,55.1,9,10163,0,0
IA,"Kossuth County, Iowa",1357,532,825,19109,51496,7112,425,7158,327,14270,752,58,14,stable,41.4,10,15165,0,0
IA,"Lee County, Iowa",5791,2606,3185,19111,43312,15554,1813,15861,1472,31415,3285,73.2,36,stable,59.7,30,35089,0,0
IA,"Linn County, Iowa",20747,9853,10894,19113,59322,98672,7125,102735,6117,201407,13242,65.7,152,falling,47.6,110,219916,0,1
IA,"Louisa County, Iowa",1357,589,768,19115,51144,5331,366,5018,426,10349,792,64.1,9,stable,44.9,6,11185,0,0
IA,"Lucas County, Iowa",1126,596,530,19117,43962,3889,436,3961,312,7850,748,60.1,8,stable,44.5,6,8682,0,0
IA,"Lyon County, Iowa",843,404,439,19119,57130,5292,567,5245,449,10537,1016,45.2,7,stable,24.4,3,11745,0,0
IA,"Madison County, Iowa",1164,567,597,19121,60060,7185,541,7336,395,14521,936,58.2,11,stable,40.4,8,15753,0,0
IA,"Mahaska County, Iowa",3206,1330,1876,19123,48726,10334,800,10558,470,20892,1270,79.1,22,stable,66.6,19,22324,0,0
IA,"Marion County, Iowa",3124,1459,1665,19125,54693,15729,734,15889,647,31618,1381,57.4,24,stable,43.6,18,33294,0,0
IA,"Marshall County, Iowa",4429,2268,2161,19127,53351,18265,1919,18398,1389,36663,3308,65.8,35,falling,49.3,27,40746,0,1
IA,"Mills County, Iowa",1300,667,633,19129,63979,6865,528,6811,418,13676,946,73.1,13,stable,49.1,9,14844,0,0
IA,"Mitchell County, Iowa",1005,476,529,19131,49488,4662,625,4802,456,9464,1081,48.2,9,stable,24.8,5,10832,0,0
IA,"Monona County, Iowa",1233,529,704,19133,40302,4113,336,4084,343,8197,679,58.3,9,stable,46.6,8,8979,0,0
IA,"Monroe County, Iowa",944,348,596,19135,46304,3490,602,3357,417,6847,1019,74.8,9,stable,71.3,8,7973,0,0
IA,"Montgomery County, Iowa",1717,715,1002,19137,42418,4447,518,4980,327,9427,845,59,10,stable,50.8,8,10234,0,0
IA,"Muscatine County, Iowa",5219,2406,2813,19139,53676,19539,1665,19543,1683,39082,3348,62.8,31,stable,48.4,23,43011,0,0
IA,"O'Brien County, Iowa",1013,473,540,19141,55227,6514,472,6423,477,12937,949,53.2,12,stable,39.3,9,13984,0,0
IA,"Osceola County, Iowa",521,192,329,19143,49448,2812,263,2737,295,5549,558,52.1,5,stable,47.2,5,6154,0,0
IA,"Page County, Iowa",2262,1116,1146,19145,43912,6505,822,6810,597,13315,1419,98,23,stable,50.1,12,15527,0,0
IA,"Palo Alto County, Iowa",948,421,527,19147,47113,4213,355,4197,240,8410,595,61.1,9,stable,35.2,5,9133,0,0
IA,"Plymouth County, Iowa",1907,817,1090,19149,57130,11390,766,11769,636,23159,1402,54.9,18,stable,40.6,14,24800,0,0
IA,"Pocahontas County, Iowa",987,458,529,19151,45069,3169,326,3264,208,6433,534,52.4,6,stable,35.5,5,7008,0,0
IA,"Polk County, Iowa",57143,25452,31691,19153,60061,202694,17295,213559,13896,416253,31191,75.3,309,stable,57.2,233,467711,0,0
IA,"Pottawattamie County, Iowa",11779,5050,6729,19155,51976,40374,4897,43002,3788,83376,8685,84.6,94,stable,61.5,68,93671,0,0
IA,"Poweshiek County, Iowa",1767,731,1036,19157,51006,8281,576,8937,594,17218,1170,43.4,12,stable,31.8,9,18550,0,0
IA,"Ringgold County, Iowa",514,206,308,19159,47042,2148,282,2171,273,4319,555,46.1,4,stable,41.2,4,5068,0,0
IA,"Sac County, Iowa",805,304,501,19161,49572,4568,358,4657,324,9225,682,57.4,10,stable,37.7,6,10021,0,0
IA,"Scott County, Iowa",20229,8767,11462,19163,55114,74793,7742,80096,5650,154889,13392,72.7,134,stable,53.2,99,172126,0,0
IA,"Shelby County, Iowa",1307,600,707,19165,50952,5277,539,5582,372,10859,911,52.4,10,stable,37,7,11927,0,0
IA,"Sioux County, Iowa",2663,1099,1564,19167,61627,15807,1411,15737,1129,31544,2540,43.1,16,stable,33.9,13,34937,0,0
IA,"Story County, Iowa",19109,10045,9064,19169,50438,45559,2642,42773,1887,88332,4529,56,43,stable,41,32,96021,0,0
IA,"Tama County, Iowa",1919,903,1016,19171,55203,7763,735,7896,704,15659,1439,65.3,16,stable,39.3,10,17337,0,0
IA,"Taylor County, Iowa",860,386,474,19173,44246,2683,396,2720,312,5403,708,57.9,6,stable,52.7,5,6205,0,0
IA,"Union County, Iowa",1676,669,1007,19175,44351,5477,483,5890,585,11367,1068,74.3,13,stable,56.5,10,12469,0,0
IA,"Van Buren County, Iowa",1095,545,550,19177,45111,3256,524,3112,473,6368,997,75.4,9,rising,52.4,6,7344,1,0
IA,"Wapello County, Iowa",6399,3090,3309,19179,42095,15390,1800,16210,1526,31600,3326,78.5,36,stable,55.5,25,35173,0,0
IA,"Warren County, Iowa",3124,1413,1711,19181,64447,21891,1175,22863,1028,44754,2203,69.5,37,stable,48.4,25,48626,0,0
IA,"Washington County, Iowa",2013,883,1130,19183,56390,9615,1082,9902,1095,19517,2177,52.9,16,stable,39.6,12,22247,0,0
IA,"Wayne County, Iowa",834,372,462,19185,43358,2650,385,2814,433,5464,818,63.7,6,stable,41.2,4,6385,0,0
IA,"Webster County, Iowa",5210,2122,3088,19187,42408,15924,1780,16616,1216,32540,2996,67.6,34,stable,46,23,37071,0,0
IA,"Winnebago County, Iowa",995,465,530,19189,47668,4821,308,5032,234,9853,542,61.3,10,rising,51.5,8,10609,1,0
IA,"Winneshiek County, Iowa",1507,676,831,19191,54429,9724,563,9833,484,19557,1047,36,10,stable,22.2,7,20709,0,0
IA,"Woodbury County, Iowa",14557,6122,8435,19193,46720,43575,6383,47044,4576,90619,10959,71.5,79,stable,51.5,57,102782,0,0
IA,"Worth County, Iowa",887,389,498,19195,48459,3395,305,3519,243,6914,548,45.3,5,stable,30.7,4,7569,0,0
IA,"Wright County, Iowa",1412,649,763,19197,43698,5785,580,5903,489,11688,1069,56.1,12,stable,40.3,9,12773,0,0
ID,"Ada County, Idaho",50551,24218,26333,16001,56356,179687,24140,186069,21581,365756,45721,52.2,191,stable,37.6,136,434211,0,0
ID,"Bannock County, Idaho",15288,7053,8235,16005,43779,35907,5326,35846,5215,71753,10541,41,32,stable,32.5,25,83744,0,0
ID,"Benewah County, Idaho",1490,695,795,16009,39863,3578,964,3616,844,7194,1808,79,10,stable,67.7,9,9052,0,0
ID,"Bingham County, Idaho",6093,2801,3292,16011,50155,19203,3329,19504,3105,38707,6434,38.7,18,stable,31.9,15,44990,0,0
ID,"Boise County, Idaho",991,490,501,16015,44238,3004,611,2874,368,5878,979,69.2,6,stable,38.3,3,7058,0,0
ID,"Bonner County, Idaho",6145,2946,3199,16017,42171,16871,3473,17198,3180,34069,6653,54.3,32,stable,43.7,26,41859,0,0
ID,"Bonneville County, Idaho",14025,6101,7924,16019,50762,45074,7432,47260,6823,92334,14255,35.7,35,stable,25.4,24,110089,0,0
ID,"Boundary County, Idaho",1647,774,873,16021,38961,4380,1173,3939,1397,8319,2570,46.3,7,stable,35.4,5,11318,0,0
ID,"Canyon County, Idaho",37945,17283,20662,16027,42888,79546,18096,82935,16843,162481,34939,56.1,99,stable,40.8,72,207478,0,0
ID,"Cassia County, Idaho",3645,1616,2029,16031,45695,9384,2297,9055,2252,18439,4549,34,8,stable,26.9,6,23506,0,0
ID,"Clearwater County, Idaho",985,423,562,16035,38837,3224,522,3185,591,6409,1113,55.4,8,stable,40.7,6,8496,0,0
ID,"Elmore County, Idaho",4046,1773,2273,16039,43848,9973,1643,10638,1656,20611,3299,72.4,17,stable,59.2,13,25876,0,0
ID,"Fremont County, Idaho",1266,601,665,16043,47988,5200,902,5250,990,10450,1892,40.4,6,stable,31.7,5,12819,0,0
ID,"Gem County, Idaho",2980,1404,1576,16045,40828,6654,1658,6630,1648,13284,3306,67.1,17,stable,51,13,16852,0,0
ID,"Gooding County, Idaho",2911,1593,1318,16047,39930,5885,1938,5746,1581,11631,3519,66.9,12,stable,43.7,8,15284,0,0
ID,"Idaho County, Idaho",2528,1219,1309,16049,38191,6967,1125,6473,1223,13440,2348,48.2,14,stable,36.3,10,16272,0,0
ID,"Jefferson County, Idaho",3492,1558,1934,16051,51171,11265,2219,11699,1550,22964,3769,33.9,7,stable,31.2,7,27157,0,0
ID,"Jerome County, Idaho",3676,1577,2099,16053,41630,8327,3044,8345,2816,16672,5860,48,10,stable,35.8,7,22814,0,0
ID,"Kootenai County, Idaho",18634,8293,10341,16055,49403,59838,11075,61963,10877,121801,21952,56.6,96,stable,41.2,69,150346,0,0
ID,"Latah County, Idaho",7597,3909,3688,16057,42439,17900,1704,16876,1693,34776,3397,50.6,17,stable,37.2,12,38778,0,0
ID,"Lemhi County, Idaho",1430,657,773,16059,34329,3298,602,3193,606,6491,1208,46.5,7,stable,40.6,6,7735,0,0
ID,"Minidoka County, Idaho",3501,1562,1939,16067,44853,7661,2570,7775,2174,15436,4744,54.8,13,stable,38.1,9,20461,0,0
ID,"Nez Perce County, Idaho",4581,2166,2415,16069,48160,16662,2619,17470,2343,34132,4962,69.3,38,stable,54,30,40048,0,0
ID,"Owyhee County, Idaho",3091,1580,1511,16073,33440,4083,1696,4060,1385,8143,3081,40.7,5,stable,48.9,6,11310,0,0
ID,"Payette County, Idaho",4152,1963,2189,16075,44257,9157,2205,8899,2287,18056,4492,64.8,18,stable,40.3,11,22896,0,0
ID,"Shoshone County, Idaho",2108,1006,1102,16079,37665,5282,950,5050,1088,10332,2038,98.7,20,stable,74.8,15,12432,0,0
ID,"Twin Falls County, Idaho",12418,5566,6852,16083,44048,31896,7143,33910,6119,65806,13262,53.4,47,stable,42,37,82375,0,0
ID,"Valley County, Idaho",1434,857,577,16085,48384,3987,1012,3991,647,7978,1659,41.3,6,stable,27.8,4,10103,0,0
ID,"Washington County, Idaho",1798,886,912,16087,34775,4079,918,3849,1041,7928,1959,68.3,11,stable,54.4,8,9984,0,0
IL,"Adams County, Illinois",9433,4259,5174,17001,45965,28948,3173,31295,2375,60243,5548,74.1,68,stable,50.8,48,67013,0,0
IL,"Alexander County, Illinois",2424,1018,1406,17003,27265,2784,619,3204,517,5988,1136,93.5,11,stable,66,7,6780,0,0
IL,"Bond County, Illinois",2593,1121,1472,17005,47946,7306,520,8056,347,15362,867,70.2,15,stable,47,10,16950,0,0
IL,"Boone County, Illinois",5841,2237,3604,17007,58248,24063,2679,24223,2568,48286,5247,66.3,36,stable,52.8,28,53585,0,0
IL,"Brown County, Illinois",565,305,260,17009,50739,2570,194,2292,135,4862,329,81.4,6,stable,46.6,3,6829,0,0
IL,"Bureau County, Illinois",4191,1800,2391,17011,50423,14846,1743,15866,1269,30712,3012,69.6,34,stable,50.4,25,33587,0,0
IL,"Calhoun County, Illinois",606,294,312,17013,53869,2333,147,2349,90,4682,237,81.4,6,stable,47.8,4,4899,0,0
IL,"Carroll County, Illinois",1843,894,949,17015,48631,6529,829,6845,546,13374,1375,54,14,stable,47.4,12,14616,0,0
IL,"Cass County, Illinois",1688,775,913,17017,47434,6014,693,5811,576,11825,1269,89.7,15,stable,72.4,12,12847,0,0
IL,"Champaign County, Illinois",43284,21117,22167,17019,46495,92122,9537,95737,6476,187859,16013,62.4,107,stable,42.4,73,208861,0,0
IL,"Christian County, Illinois",4714,1953,2761,17021,45334,14242,1622,15615,940,29857,2562,94.1,45,stable,69.2,33,33642,0,0
IL,"Clark County, Illinois",2360,995,1365,17023,50517,6969,759,7522,678,14491,1437,75.5,17,stable,56.1,13,15979,0,0
IL,"Clay County, Illinois",1839,719,1120,17025,44209,5900,719,6221,566,12121,1285,79.5,15,stable,55.8,11,13428,0,0
IL,"Clinton County, Illinois",3193,1251,1942,17027,63236,16679,1061,17243,1018,33922,2079,63.6,29,stable,43.9,20,37786,0,0
IL,"Coles County, Illinois",10951,4833,6118,17029,39588,22166,3037,25035,2111,47201,5148,80.4,48,stable,56.1,34,52521,0,0
IL,"Cook County, Illinois",879499,392713,486786,17031,55251,2103599,410838,2348142,330018,4451741,740856,63.4,3359,falling,44.7,"2,369",5238216,0,1
IL,"Crawford County, Illinois",2310,1127,1183,17033,47468,7860,1003,8562,736,16422,1739,88.9,24,stable,55.5,15,19414,0,0
IL,"Cumberland County, Illinois",1700,755,945,17035,46061,5052,410,5011,344,10063,754,89.1,13,stable,62.6,9,10898,0,0
IL,"DeKalb County, Illinois",18336,7881,10455,17037,54101,45996,5120,47894,4510,93890,9630,72.8,63,stable,46.2,40,104352,0,0
IL,"De Witt County, Illinois",2073,936,1137,17039,53959,7261,845,7595,448,14856,1293,94.3,21,stable,78.1,17,16247,0,0
IL,"Douglas County, Illinois",2019,829,1190,17041,51810,7827,1829,8266,1748,16093,3577,66.3,17,stable,46.2,12,19823,0,0
IL,"DuPage County, Illinois",67941,30099,37842,17043,79658,411862,42255,435524,34940,847386,77195,56.1,529,falling,38.7,362,933736,0,1
IL,"Edgar County, Illinois",2999,1370,1629,17045,45691,7988,698,8274,762,16262,1460,76.6,20,stable,59.7,16,17664,0,0
IL,"Edwards County, Illinois",851,364,487,17047,44497,2924,344,3146,201,6070,545,88.7,9,stable,60.7,6,6534,0,0
IL,"Effingham County, Illinois",3557,1758,1799,17049,52224,15617,1332,15938,1040,31555,2372,67.5,29,stable,45.2,19,34371,0,0
IL,"Fayette County, Illinois",3644,1651,1993,17051,43944,8549,1573,9305,1070,17854,2643,58,16,stable,43.7,13,22043,0,0
IL,"Ford County, Illinois",1790,792,998,17053,49947,5896,759,6325,444,12221,1203,66.8,14,stable,48.3,11,13736,0,0
IL,"Franklin County, Illinois",7191,3279,3912,17055,39512,17019,2304,17973,1920,34992,4224,103.4,59,stable,73.7,42,39485,0,0
IL,"Fulton County, Illinois",4838,2193,2645,17057,46083,15208,1655,16087,1139,31295,2794,74.9,38,stable,54.2,28,35699,0,0
IL,"Gallatin County, Illinois",837,375,462,17059,39636,2279,291,2598,217,4877,508,87.9,8,falling,74.1,7,5265,0,1
IL,"Greene County, Illinois",2231,994,1237,17061,42565,5958,630,6055,601,12013,1231,72.7,14,stable,55.7,11,13241,0,0
IL,"Grundy County, Illinois",4531,1897,2634,17063,65887,23054,1929,23379,1691,46433,3620,90,45,stable,55.3,28,50541,0,0
IL,"Hamilton County, Illinois",1211,565,646,17065,44159,3633,433,3779,396,7412,829,85.2,11,stable,80.2,10,8200,0,0
IL,"Hancock County, Illinois",2159,950,1209,17067,47699,8424,750,8769,629,17193,1379,74.4,21,stable,54.9,16,18543,0,0
IL,"Hardin County, Illinois",864,355,509,17069,38838,1854,295,1872,172,3726,467,90.3,6,stable,57.4,4,4135,0,0
IL,"Henderson County, Illinois",692,230,462,17071,47672,3131,263,3331,252,6462,515,78.2,9,stable,62.3,7,6995,0,0
IL,"Henry County, Illinois",5256,2166,3090,17073,53480,22242,2034,23560,1281,45802,3315,74.9,52,stable,57.1,40,49489,0,0
IL,"Iroquois County, Illinois",4735,2010,2725,17075,47834,12646,1403,13538,1009,26184,2412,72,31,stable,52,23,28672,0,0
IL,"Jackson County, Illinois",16853,8533,8320,17077,33871,26309,3171,27085,2267,53394,5438,69,41,stable,47.2,28,59362,0,0
IL,"Jasper County, Illinois",881,319,562,17079,54209,4354,425,4455,338,8809,763,67.3,9,stable,64.3,8,9607,0,0
IL,"Jefferson County, Illinois",6179,2740,3439,17081,43247,16146,1840,16917,1633,33063,3473,92.7,46,falling,68.7,34,38353,0,1
IL,"Jersey County, Illinois",1590,559,1031,17083,53271,9880,1023,10390,988,20270,2011,78.7,23,stable,62.3,19,22372,0,0
IL,"Jo Daviess County, Illinois",2032,849,1183,17085,53221,10402,789,10313,741,20715,1530,55.9,22,stable,44.8,17,22086,0,0
IL,"Johnson County, Illinois",1589,761,828,17087,42287,4825,579,5104,431,9929,1010,83.6,15,stable,60.5,10,12762,0,0
IL,"Kane County, Illinois",59033,26663,32370,17089,70696,224538,34989,234737,27421,459275,62410,58.9,266,stable,43.7,193,530847,0,0
IL,"Kankakee County, Illinois",17365,7945,9420,17091,52110,47095,6334,52251,4214,99346,10548,73.6,94,stable,55.1,70,110879,0,0
IL,"Kendall County, Illinois",6616,2622,3994,17093,84385,55861,3639,57763,2523,113624,6162,54.6,45,stable,39.3,32,123355,0,0
IL,"Knox County, Illinois",9013,4050,4963,17095,39976,21329,2604,23479,1962,44808,4566,69.1,53,stable,52.5,40,51441,0,0
IL,"Lake County, Illinois",65728,30540,35188,17097,78026,300937,38450,317800,30477,618737,68927,58.2,379,stable,40.1,257,703910,0,0
IL,"LaSalle County, Illinois",14386,6252,8134,17099,50633,48455,5875,50956,4462,99411,10337,76.4,113,stable,56.5,84,111333,0,0
IL,"Lawrence County, Illinois",1509,549,960,17101,40841,4119,444,6007,591,10126,1035,88.2,19,stable,66.4,14,16491,0,0
IL,"Lee County, Illinois",3555,1680,1875,17103,52379,14529,1484,14968,1281,29497,2765,66.9,31,falling,53.2,25,34584,0,1
IL,"Livingston County, Illinois",3897,1699,2198,17105,54254,15541,1274,15881,997,31422,2271,81.6,40,stable,49.7,25,36671,0,0
IL,"Logan County, Illinois",3303,1336,1967,17107,50539,10390,973,11924,710,22314,1683,90.7,34,stable,52.9,20,29494,0,0
IL,"McDonough County, Illinois",6394,2743,3651,17109,40314,14128,1315,15125,1068,29253,2383,63.1,23,stable,50.1,18,31333,0,0
IL,"McHenry County, Illinois",24037,11663,12374,17111,77222,139659,12815,142634,10986,282293,23801,65.3,185,falling,51.9,143,307343,0,1
IL,"McLean County, Illinois",23795,10918,12877,17113,62211,77943,5782,83708,4527,161651,10309,64.1,97,stable,44.7,68,173166,0,0
IL,"Macon County, Illinois",19411,8246,11165,17115,47176,45971,5397,51455,3950,97426,9347,96.6,140,falling,62.8,92,107303,0,1
IL,"Macoupin County, Illinois",5729,2375,3354,17117,51206,20678,2287,21756,1563,42434,3850,79.5,52,stable,59.9,39,46045,0,0
IL,"Madison County, Illinois",34818,15421,19397,17119,53431,117515,12327,126195,8900,243710,21227,83.5,265,falling,58.5,186,266209,0,1
IL,"Marion County, Illinois",6965,3100,3865,17121,42238,16340,2262,17635,1717,33975,3979,91.5,49,stable,67.6,36,38339,0,0
IL,"Marshall County, Illinois",1201,439,762,17123,53423,5466,436,5677,329,11143,765,58.5,12,stable,44,9,11982,0,0
IL,"Mason County, Illinois",2095,919,1176,17125,41567,6283,631,6482,537,12765,1168,92.3,20,stable,63.9,14,13701,0,0
IL,"Massac County, Illinois",2705,1251,1454,17127,40977,6263,903,6897,731,13160,1634,100.9,22,stable,67.9,15,14766,0,0
IL,"Menard County, Illinois",1404,603,801,17129,60486,5691,395,6065,299,11756,694,75.9,13,stable,62.1,10,12444,0,0
IL,"Mercer County, Illinois",1498,616,882,17131,54757,7464,421,7559,407,15023,828,76.7,19,stable,48.2,12,15858,0,0
IL,"Monroe County, Illinois",1667,529,1138,17133,70859,15483,875,16248,643,31731,1518,60.9,24,stable,43.6,17,33879,0,0
IL,"Montgomery County, Illinois",3503,1170,2333,17135,46966,9479,581,13000,822,22479,1403,86.5,34,stable,68.5,28,28898,0,0
IL,"Morgan County, Illinois",4580,2222,2358,17137,45978,14710,1702,15971,980,30681,2682,77.6,36,stable,50.2,23,34828,0,0
IL,"Moultrie County, Illinois",1929,1000,929,17139,49681,6220,961,6573,851,12793,1812,56.9,11,stable,46.1,9,14931,0,0
IL,"Ogle County, Illinois",5477,2460,3017,17141,54849,23669,2237,23986,2004,47655,4241,66.7,45,stable,45.8,31,51659,0,0
IL,"Peoria County, Illinois",31194,13602,17592,17143,51147,80195,9174,88941,6532,169136,15706,84,180,stable,60.1,129,186221,0,0
IL,"Perry County, Illinois",3380,1383,1997,17145,42478,8538,1052,9344,779,17882,1831,74.4,21,stable,52.8,15,21543,0,0
IL,"Piatt County, Illinois",1019,398,621,17147,66261,7673,465,7898,409,15571,874,79.8,18,stable,53.1,12,16387,0,0
IL,"Pike County, Illinois",2133,1011,1122,17149,40588,6805,886,7199,721,14004,1607,68.4,17,stable,46,11,15989,0,0
IL,"Pope County, Illinois",615,247,368,17151,39223,1911,159,1934,122,3845,281,105.5,7,falling,69.4,4,4226,0,1
IL,"Pulaski County, Illinois",1178,529,649,17153,31980,2536,325,2743,259,5279,584,113.1,10,stable,74.3,7,5678,0,0
IL,"Putnam County, Illinois",691,304,387,17155,56358,2658,278,2665,215,5323,493,73.5,7,stable,55,5,5644,0,0
IL,"Randolph County, Illinois",3816,1716,2100,17157,48158,13720,1275,13830,1116,27550,2391,78.6,33,stable,52.6,22,32852,0,0
IL,"Richland County, Illinois",2382,1001,1381,17159,44127,7236,745,7280,656,14516,1401,81.6,19,rising,56.7,13,16029,1,0
IL,"Rock Island County, Illinois",21223,9137,12086,17161,48817,63474,7177,68428,5696,131902,12873,66.8,127,stable,52.4,101,146133,0,0
IL,"St. Clair County, Illinois",47946,20261,27685,17163,49895,109781,15069,125311,11067,235092,26136,75.8,219,stable,56.8,165,264052,0,0
IL,"Saline County, Illinois",5534,2362,3172,17165,38258,10329,1377,11365,1164,21694,2541,91.8,33,stable,69.5,25,24548,0,0
IL,"Sangamon County, Illinois",30297,13769,16528,17167,56167,85893,8590,96636,5726,182529,14316,77.6,183,stable,54.1,126,198712,0,0
IL,"Schuyler County, Illinois",1382,885,497,17169,47723,2901,954,3084,293,5985,1247,82.9,9,stable,61.5,7,7032,0,0
IL,"Scott County, Illinois",712,332,380,17171,47222,2232,281,2485,152,4717,433,83.2,6,stable,52.1,4,5092,0,0
IL,"Shelby County, Illinois",2449,1159,1290,17173,47850,9821,1147,10223,732,20044,1879,77.1,25,stable,46.9,16,21775,0,0
IL,"Stark County, Illinois",684,271,413,17175,50085,2569,280,2704,205,5273,485,77.3,7,stable,46.5,4,5788,0,0
IL,"Stephenson County, Illinois",6849,2985,3864,17177,45331,20113,2171,22010,1584,42123,3755,63.8,43,stable,52.6,36,45749,0,0
IL,"Tazewell County, Illinois",11559,4787,6772,17179,58194,60428,4933,63659,4342,124087,9275,87.2,151,falling,60.1,104,134800,0,1
IL,"Union County, Illinois",2971,1495,1476,17181,42606,7728,927,7935,808,15663,1735,102.7,26,stable,74.4,18,17408,0,0
IL,"Vermilion County, Illinois",14571,6430,8141,17183,42977,33321,4625,37214,2928,70535,7553,86.4,92,stable,64.8,70,79282,0,0
IL,"Wabash County, Illinois",1447,617,830,17185,47491,5240,427,5446,456,10686,883,91.6,15,falling,59.7,10,11542,0,1
IL,"Warren County, Illinois",2464,992,1472,17187,43699,7792,751,8299,666,16091,1417,74,17,stable,57.1,13,17527,0,0
IL,"Washington County, Illinois",1834,861,973,17189,53202,6555,581,6684,428,13239,1009,74.1,15,stable,43.4,9,14270,0,0
IL,"Wayne County, Illinois",2385,1052,1333,17191,44993,7396,786,7712,612,15108,1398,89.2,22,stable,66.4,17,16423,0,0
IL,"White County, Illinois",1916,825,1091,17193,44648,6151,687,6747,545,12898,1232,81.2,18,falling,69.5,16,14327,0,1
IL,"Whiteside County, Illinois",6740,2999,3741,17195,47401,25020,2804,26751,2076,51771,4880,71.8,57,stable,56.7,45,57079,0,0
IL,"Will County, Illinois",53482,22781,30701,17197,76101,303905,30668,319482,23374,623387,54042,72,414,falling,50.3,281,687263,0,1
IL,"Williamson County, Illinois",9783,4284,5499,17199,44453,28472,3366,30947,2498,59419,5864,97.5,85,stable,69.5,60,67466,0,0
IL,"Winnebago County, Illinois",47851,21483,26368,17201,48225,123333,16996,134331,12616,257664,29612,74,252,stable,57.7,198,287078,0,0
IL,"Woodford County, Illinois",3105,1461,1644,17203,65852,17966,1257,18355,970,36321,2227,61,29,stable,45.8,22,39227,0,0
IN,"Adams County, Indiana",5529,2596,2933,18001,48188,12964,4012,13100,4142,26064,8154,50.2,19,rising,32.9,13,34980,1,0
IN,"Allen County, Indiana",56542,25163,31379,18003,49092,150074,25374,160131,24245,310205,49619,61.9,227,stable,44.8,163,368450,0,0
IN,"Bartholomew County, Indiana",10027,4645,5382,18005,55050,34684,4348,34960,4574,69644,8922,77.8,69,stable,59.2,53,81162,0,0
IN,"Benton County, Indiana",1181,512,669,18007,47046,3646,702,3807,512,7453,1214,82.7,9,stable,79.3,9,8681,0,0
IN,"Blackford County, Indiana",1700,664,1036,18009,38190,5134,903,5344,923,10478,1826,74.9,13,stable,51.8,10,12298,0,0
IN,"Boone County, Indiana",3498,1551,1947,18011,67552,27235,2530,27975,2173,55210,4703,67,39,stable,56.6,31,63344,0,0
IN,"Brown County, Indiana",1865,959,906,18013,54615,6408,1077,6463,932,12871,2009,61.8,14,stable,60.2,13,14977,0,0
IN,"Carroll County, Indiana",2149,895,1254,18015,52005,8330,1557,8678,1334,17008,2891,66.1,17,stable,39.8,10,19856,0,0
IN,"Cass County, Indiana",5884,2717,3167,18017,42290,15674,3128,16226,2792,31900,5920,89.5,42,stable,65.8,31,37979,0,0
IN,"Clark County, Indiana",12009,5616,6393,18019,51699,46813,7703,50697,6414,97510,14117,88.1,107,stable,67.3,81,115371,0,0
IN,"Clay County, Indiana",3807,1695,2112,18021,47602,11270,1629,11934,1533,23204,3162,73.8,25,stable,58.4,20,26503,0,0
IN,"Clinton County, Indiana",4504,2018,2486,18023,48478,13628,2176,14134,2246,27762,4422,76.2,29,stable,62.2,24,32609,0,0
IN,"Crawford County, Indiana",2166,975,1191,18025,38695,4818,520,4698,496,9516,1016,94.6,13,stable,70.5,10,10483,0,0
IN,"Daviess County, Indiana",4192,1934,2258,18027,47342,12618,3375,12601,3357,25219,6732,62.8,23,stable,56,20,32906,0,0
IN,"Dearborn County, Indiana",4553,1982,2571,18029,58680,22206,2249,22495,2168,44701,4417,82.3,48,stable,64.1,37,49455,0,0
IN,"Decatur County, Indiana",3647,1518,2129,18031,49799,11143,1689,11404,1686,22547,3375,69.6,21,stable,56.9,17,26521,0,0
IN,"DeKalb County, Indiana",6107,2741,3366,18033,48341,18100,2885,18259,2832,36359,5717,68.5,33,stable,53.2,25,42589,0,0
IN,"Delaware County, Indiana",24209,10795,13414,18035,38830,47799,7995,53817,6250,101616,14245,79.9,108,stable,58.6,80,116852,0,0
IN,"Dubois County, Indiana",4071,1772,2299,18037,53513,19082,1645,19285,1483,38367,3128,55,28,stable,40.3,20,42461,0,0
IN,"Elkhart County, Indiana",31601,12817,18784,18039,47913,78600,19159,81781,18674,160381,37833,70.2,144,stable,48.6,99,203474,0,0
IN,"Fayette County, Indiana",4806,2129,2677,18041,39379,9694,1943,9985,1830,19679,3773,87.4,29,stable,71.4,24,23434,0,0
IN,"Floyd County, Indiana",9530,4041,5489,18043,54914,32243,4169,34587,3904,66830,8073,79.3,67,stable,54.2,46,76778,0,0
IN,"Fountain County, Indiana",1992,870,1122,18045,46760,7363,1018,7597,737,14960,1755,82.3,20,stable,62.2,15,16591,0,0
IN,"Franklin County, Indiana",2413,1094,1319,18047,51748,10385,1059,10442,968,20827,2027,64.7,18,stable,57.1,16,22872,0,0
IN,"Fulton County, Indiana",3011,1441,1570,18049,45332,8761,1357,8876,1304,17637,2661,83.8,23,stable,70,19,20315,0,0
IN,"Gibson County, Indiana",3675,1611,2064,18051,48303,14615,1936,14958,1606,29573,3542,70,29,stable,48.6,20,33775,0,0
IN,"Grant County, Indiana",11829,5068,6761,18053,40294,27995,4428,31014,4506,59009,8934,85.5,78,stable,64,59,67979,0,0
IN,"Greene County, Indiana",4398,1869,2529,18055,45397,13772,2387,14446,1927,28218,4314,81.1,35,stable,69.5,30,32441,0,0
IN,"Hamilton County, Indiana",13889,5730,8159,18057,86222,133967,10141,141488,9471,275455,19612,46.7,102,stable,33.6,73,309697,0,0
IN,"Hancock County, Indiana",4583,1738,2845,18059,66606,31559,3012,33142,2993,64701,6005,83.1,65,stable,59.2,45,72520,0,0
IN,"Harrison County, Indiana",5392,2399,2993,18061,52128,17348,2105,17730,1840,35078,3945,90.7,43,rising,62.9,29,39578,1,0
IN,"Hendricks County, Indiana",7514,2643,4871,18063,70163,67526,6690,70754,5627,138280,12317,69.9,98,falling,50.5,69,158192,0,1
IN,"Henry County, Indiana",7465,3105,4360,18065,41855,18933,3496,20315,3185,39248,6681,76.6,49,stable,65.1,42,48985,0,0
IN,"Howard County, Indiana",14445,6520,7925,18067,44226,34676,4721,37634,4798,72310,9519,75,81,stable,52.4,57,82556,0,0
IN,"Huntington County, Indiana",4241,1829,2412,18069,46945,15653,2203,16607,1913,32260,4116,65,29,stable,50.5,23,36630,0,0
IN,"Jackson County, Indiana",6297,2608,3689,18071,47000,18573,2785,18665,2816,37238,5601,81.4,42,stable,70.7,37,44069,0,0
IN,"Jasper County, Indiana",2710,1252,1458,18073,55374,14816,1581,14772,1932,29588,3513,85.6,33,stable,69.4,27,33470,0,0
IN,"Jay County, Indiana",3400,1570,1830,18075,41021,8849,1480,9460,1250,18309,2730,68.9,18,stable,57.7,15,21121,0,0
IN,"Jefferson County, Indiana",4343,1949,2394,18077,45718,13271,2024,13793,1916,27064,3940,81.7,32,stable,58.5,23,32416,0,0
IN,"Jennings County, Indiana",4390,2189,2201,18079,44736,12221,1730,12293,1615,24514,3345,97.9,30,stable,62.5,20,27897,0,0
IN,"Johnson County, Indiana",14205,6368,7837,18081,62147,62927,7284,66581,6702,129508,13986,67.9,101,stable,50.1,73,149633,0,0
IN,"Knox County, Indiana",5630,2479,3151,18083,42725,16560,2242,15792,2655,32352,4897,76,37,stable,53.6,26,37927,0,0
IN,"Kosciusko County, Indiana",8645,3964,4681,18085,52821,32774,5682,33738,5039,66512,10721,71.6,64,stable,54,47,78620,0,0
IN,"LaGrange County, Indiana",4909,2157,2752,18087,49964,11118,8061,10668,8069,21786,16130,56.4,21,stable,41.5,15,38809,0,0
IN,"Lake County, Indiana",87203,37304,49899,18089,50135,201307,34810,220117,31833,421424,66643,74,412,stable,53.8,298,487865,0,0
IN,"LaPorte County, Indiana",17792,7191,10601,18091,46872,43254,5861,47298,5999,90552,11860,77.2,103,stable,55.9,74,110884,0,0
IN,"Lawrence County, Indiana",5850,2758,3092,18093,45875,18953,3406,19695,3087,38648,6493,89.5,55,stable,66,41,45495,0,0
IN,"Madison County, Indiana",21089,9753,11336,18095,44195,51832,8896,56889,7522,108721,16418,81.8,133,stable,67.8,111,129723,0,0
IN,"Marion County, Indiana",191309,86399,104910,18097,42168,362748,78114,411127,64482,773875,142596,79.7,682,stable,64.3,545,939020,0,0
IN,"Marshall County, Indiana",5594,2265,3329,18099,48485,19603,3532,19708,3640,39311,7172,67.1,39,stable,45.1,26,46857,0,0
IN,"Martin County, Indiana",1320,532,788,18101,44589,4408,705,4409,647,8817,1352,71.5,10,stable,58.6,8,10226,0,0
IN,"Miami County, Indiana",5174,2271,2903,18103,45184,15202,2349,14794,1817,29996,4166,77.1,34,stable,68,29,35862,0,0
IN,"Monroe County, Indiana",31707,15337,16370,18105,42404,62102,8313,63785,7277,125887,15590,66.9,81,stable,49.7,61,144705,0,0
IN,"Montgomery County, Indiana",5153,2408,2745,18107,48213,16552,2590,16354,2147,32906,4737,70,33,stable,54.5,26,38227,0,0
IN,"Morgan County, Indiana",8237,3406,4831,18109,55432,29956,3980,31211,3523,61167,7503,83.9,65,stable,66.4,52,69648,0,0
IN,"Newton County, Indiana",1892,703,1189,18111,46895,5948,1060,5930,916,11878,1976,75.3,15,stable,65.7,13,14008,0,0
IN,"Noble County, Indiana",5665,2582,3083,18113,49331,20425,2984,20259,3059,40684,6043,69,35,stable,54.7,28,47733,0,0
IN,"Ohio County, Indiana",470,219,251,18115,48780,2633,363,2688,297,5321,660,123.2,10,stable,80.6,7,5938,0,0
IN,"Orange County, Indiana",3403,1562,1841,18117,39812,8431,1230,8677,1134,17108,2364,85.4,22,stable,69.7,18,19605,0,0
IN,"Owen County, Indiana",3172,1535,1637,18119,43948,8672,1969,8981,1411,17653,3380,85,24,stable,62.9,17,20872,0,0
IN,"Parke County, Indiana",2486,1103,1383,18121,40781,6668,1341,6589,981,13257,2322,75.1,17,stable,64,14,16901,0,0
IN,"Perry County, Indiana",2276,1020,1256,18123,47470,7972,836,8028,831,16000,1667,101.2,24,stable,76,18,19347,0,0
IN,"Pike County, Indiana",1243,579,664,18125,44399,5557,670,5607,629,11164,1299,66.6,12,stable,57.9,10,12594,0,0
IN,"Porter County, Indiana",18850,8093,10757,18127,63926,73133,8037,75759,8265,148892,16302,73.6,133,stable,52.9,95,167688,0,0
IN,"Posey County, Indiana",2801,1480,1321,18129,58101,11771,823,11940,782,23711,1605,60.3,19,stable,41.3,13,25512,0,0
IN,"Pulaski County, Indiana",1808,707,1101,18131,43836,5661,855,5588,777,11249,1632,71.1,13,stable,64.5,12,12889,0,0
IN,"Putnam County, Indiana",3245,1391,1854,18133,51355,14904,2042,15700,1728,30604,3770,95.1,41,stable,76.4,33,37585,0,0
IN,"Randolph County, Indiana",4522,1782,2740,18135,40810,10277,2030,11109,1822,21386,3852,83.1,29,stable,59.1,21,25172,0,0
IN,"Ripley County, Indiana",2403,1042,1361,18137,51170,12406,1488,13193,1063,25599,2551,75.6,27,stable,57.8,20,28701,0,0
IN,"Rush County, Indiana",2946,1189,1757,18139,45121,7088,1260,7480,976,14568,2236,80.8,18,stable,67.5,15,16672,0,0
IN,"St. Joseph County, Indiana",45532,19992,25540,18141,45471,110161,17834,121115,15619,231276,33453,71.5,212,falling,52.2,157,268441,0,1
IN,"Scott County, Indiana",4148,1896,2252,18143,44442,9893,1578,10912,1052,20805,2630,91.8,26,stable,81.2,23,23744,0,0
IN,"Shelby County, Indiana",5302,2258,3044,18145,53584,18589,2948,19630,2561,38219,5509,81.8,43,stable,56.2,30,44478,0,0
IN,"Spencer County, Indiana",2213,906,1307,18147,55247,9548,894,9375,821,18923,1715,77.9,21,stable,51.3,14,20715,0,0
IN,"Starke County, Indiana",3682,1634,2048,18149,42208,10130,1260,10415,1307,20545,2567,93.5,29,stable,75.3,23,22958,0,0
IN,"Steuben County, Indiana",3542,1577,1965,18151,48472,15095,2153,14737,2002,29832,4155,71,31,rising,46.7,20,34372,1,0
IN,"Sullivan County, Indiana",3534,1469,2065,18153,45023,7878,1578,8160,1317,16038,2895,81.8,22,stable,64,17,20928,0,0
IN,"Switzerland County, Indiana",2022,1025,997,18155,44061,4519,866,4272,731,8791,1597,84.7,11,stable,80,10,10524,0,0
IN,"Tippecanoe County, Indiana",36902,18433,18469,18157,45932,80039,11380,78153,9682,158192,21062,64,91,stable,47.2,66,185826,0,0
IN,"Tipton County, Indiana",1529,732,797,18159,51613,6741,937,6682,1027,13423,1964,73.3,16,stable,43.6,10,15267,0,0
IN,"Union County, Indiana",754,372,382,18161,44277,3159,488,3209,381,6368,869,65.2,7,stable,48.9,5,7182,0,0
IN,"Vanderburgh County, Indiana",28870,12815,16055,18163,43046,75092,11396,82866,9443,157958,20839,79.6,169,stable,57.2,122,181877,0,0
IN,"Vermillion County, Indiana",1996,896,1100,18165,43600,6822,900,7071,856,13893,1756,92.6,20,stable,79.9,18,15692,0,0
IN,"Vigo County, Indiana",20245,9199,11046,18167,40313,44041,7289,45578,7081,89619,14370,80.4,96,stable,65,77,107896,0,0
IN,"Wabash County, Indiana",4373,1771,2602,18169,45649,13812,1655,14518,1409,28330,3064,64.3,28,stable,46.5,20,32138,0,0
IN,"Warren County, Indiana",740,297,443,18171,56042,3822,278,3874,301,7696,579,66,7,falling,53.6,6,8269,0,1
IN,"Warrick County, Indiana",5926,2551,3375,18173,62185,27350,2520,28236,2148,55586,4668,66.7,47,stable,46.7,32,61897,0,0
IN,"Washington County, Indiana",4190,1900,2290,18175,41289,11739,1976,12453,1484,24192,3460,96.2,33,stable,69.6,23,27827,0,0
IN,"Wayne County, Indiana",13732,6012,7720,18177,38494,26546,5708,28928,5548,55474,11256,85.2,77,stable,65,58,67001,0,0
IN,"Wells County, Indiana",3306,1449,1857,18179,51101,12159,1298,12294,1480,24453,2778,52.4,19,stable,42.9,15,27964,0,0
IN,"White County, Indiana",2309,1029,1280,18181,52154,10690,1293,10944,1212,21634,2505,76.2,26,stable,64.4,22,24293,0,0
IN,"Whitley County, Indiana",2633,1208,1425,18183,54389,14968,1515,15078,1388,30046,2903,63.8,26,stable,52.1,21,33406,0,0
KS,"Allen County, Kansas",2257,957,1300,20001,38698,5602,779,5754,741,11356,1520,_,_,_,52.2,10,12717,0,0
KS,"Anderson County, Kansas",1362,668,694,20003,40696,3391,487,3407,509,6798,996,_,_,_,50.6,6,7808,0,0
KS,"Atchison County, Kansas",2970,1310,1660,20005,43581,6755,1145,7594,963,14349,2108,_,_,_,51.1,10,16398,0,0
KS,"Barber County, Kansas",511,245,266,20007,51811,2170,220,2078,261,4248,481,_,_,_,56,4,4823,0,0
KS,"Barton County, Kansas",4261,1840,2421,20009,44013,11051,2075,12159,1703,23210,3778,_,_,_,45.5,17,27103,0,0
KS,"Bourbon County, Kansas",2757,1175,1582,20011,38280,6495,677,6594,773,13089,1450,_,_,_,47.5,10,14712,0,0
KS,"Brown County, Kansas",1598,669,929,20013,43724,4257,506,4456,590,8713,1096,_,_,_,53.6,8,9776,0,0
KS,"Butler County, Kansas",6620,2830,3790,20015,58897,28486,2977,29710,2918,58196,5895,_,_,_,53,38,66741,0,0
KS,"Chautauqua County, Kansas",579,261,318,20019,37993,1521,247,1429,246,2950,493,_,_,_,80.1,5,3402,0,0
KS,"Cherokee County, Kansas",3511,1673,1838,20021,41388,8766,1516,9103,1346,17869,2862,_,_,_,63.2,17,20533,0,0
KS,"Clay County, Kansas",942,368,574,20027,52066,3729,200,3921,272,7650,472,_,_,_,52.9,7,8347,0,0
KS,"Cloud County, Kansas",1202,623,579,20029,39282,3958,606,4098,452,8056,1058,_,_,_,48.4,7,9219,0,0
KS,"Coffey County, Kansas",833,425,408,20031,57433,3749,456,3769,372,7518,828,_,_,_,54.4,7,8384,0,0
KS,"Cowley County, Kansas",5971,2742,3229,20035,43860,15033,2174,15862,1800,30895,3974,_,_,_,43.1,20,35788,0,0
KS,"Crawford County, Kansas",8219,4161,4058,20037,36534,16719,2730,16792,2435,33511,5165,_,_,_,59,26,39217,0,0
KS,"Dickinson County, Kansas",2005,735,1270,20041,49096,8495,940,8913,684,17408,1624,_,_,_,54.8,15,19303,0,0
KS,"Doniphan County, Kansas",892,444,448,20043,47209,3369,577,3345,455,6714,1032,_,_,_,58.1,6,7797,0,0
KS,"Douglas County, Kansas",20137,10447,9690,20045,50939,51058,6065,51232,5902,102290,11967,_,_,_,41.2,36,118053,0,0
KS,"Elk County, Kansas",483,241,242,20049,36458,1202,115,1159,159,2361,274,_,_,_,56.1,3,2605,0,0
KS,"Ellis County, Kansas",4353,2259,2094,20051,45579,12905,1447,13225,1140,26130,2587,_,_,_,37.7,12,29029,0,0
KS,"Ellsworth County, Kansas",484,171,313,20053,47736,2503,175,2531,190,5034,365,_,_,_,42.8,4,6343,0,0
KS,"Finney County, Kansas",6222,2572,3650,20055,49227,15943,2762,15431,2753,31374,5515,_,_,_,40.2,11,37118,0,0
KS,"Ford County, Kansas",6183,3303,2880,20057,50777,14180,3495,13457,3112,27637,6607,_,_,_,41.2,12,34536,0,0
KS,"Franklin County, Kansas",3264,1515,1749,20059,51081,11434,1146,11906,1105,23340,2251,_,_,_,53,16,25609,0,0
KS,"Geary County, Kansas",4463,1978,2485,20061,43992,12763,1900,15626,1357,28389,3257,_,_,_,71.4,16,37030,0,0
KS,"Greenwood County, Kansas",945,408,537,20073,38838,2702,374,2828,399,5530,773,_,_,_,52.3,6,6244,0,0
KS,"Harper County, Kansas",933,443,490,20077,43973,2493,375,2511,324,5004,699,_,_,_,53,5,5817,0,0
KS,"Harvey County, Kansas",4415,1785,2630,20079,51327,15195,1596,15987,1423,31182,3019,_,_,_,41.4,20,35073,0,0
KS,"Jackson County, Kansas",1197,414,783,20085,54077,6111,488,6198,475,12309,963,_,_,_,56.1,10,13338,0,0
KS,"Jefferson County, Kansas",1394,592,802,20087,57236,8420,1072,8561,588,16981,1660,_,_,_,47.7,12,18930,0,0
KS,"Jewell County, Kansas",466,200,266,20089,40553,1408,98,1412,93,2820,191,_,_,_,55.2,3,2970,0,0
KS,"Johnson County, Kansas",34556,14939,19617,20091,76113,253715,21313,268130,19380,521845,40693,_,_,_,39.6,210,580159,0,0
KS,"Kearny County, Kansas",412,196,216,20093,50506,1894,190,1603,189,3497,379,_,_,_,71.7,3,3956,0,0
KS,"Kingman County, Kansas",811,289,522,20095,50844,3363,510,3365,401,6728,911,_,_,_,26.5,3,7687,0,0
KS,"Labette County, Kansas",3651,1642,2009,20099,41439,8898,1349,9121,1373,18019,2722,_,_,_,56.1,16,20803,0,0
KS,"Leavenworth County, Kansas",8223,3686,4537,20103,63726,32327,2740,33288,2774,65615,5514,_,_,_,48.3,37,79315,0,0
KS,"Linn County, Kansas",1246,607,639,20107,46964,4196,420,4367,475,8563,895,_,_,_,65.1,10,9536,0,0
KS,"Lyon County, Kansas",6919,3172,3747,20111,40021,13655,2404,14734,2256,28389,4660,_,_,_,53.3,19,33339,0,0
KS,"McPherson County, Kansas",1993,704,1289,20113,56128,13319,954,13403,941,26722,1895,_,_,_,34.4,15,28941,0,0
KS,"Marion County, Kansas",1306,620,686,20115,45927,5517,413,5490,528,11007,941,_,_,_,26.8,5,12103,0,0
KS,"Marshall County, Kansas",1087,407,680,20117,45374,4446,437,4569,366,9015,803,_,_,_,37.5,6,9936,0,0
KS,"Miami County, Kansas",2949,1213,1736,20121,60966,14560,1227,15190,1119,29750,2346,_,_,_,41,15,32553,0,0
KS,"Mitchell County, Kansas",626,227,399,20123,48217,2831,305,2845,162,5676,467,_,_,_,45.4,5,6282,0,0
KS,"Montgomery County, Kansas",6303,2948,3355,20125,41083,14212,2402,14815,2214,29027,4616,_,_,_,64.4,30,33314,0,0
KS,"Morris County, Kansas",505,229,276,20127,47089,2547,272,2581,269,5128,541,_,_,_,51.3,5,5645,0,0
KS,"Nemaha County, Kansas",1129,473,656,20131,48653,4754,294,4557,285,9311,579,_,_,_,29.6,5,10227,0,0
KS,"Neosho County, Kansas",2961,1306,1655,20133,43195,7189,752,7269,985,14458,1737,_,_,_,49.7,11,16346,0,0
KS,"Osage County, Kansas",1997,852,1145,20139,49915,7134,817,7005,918,14139,1735,_,_,_,61.8,14,15847,0,0
KS,"Ottawa County, Kansas",466,217,249,20143,52479,2770,302,2607,274,5377,576,_,_,_,46.4,4,5975,0,0
KS,"Pawnee County, Kansas",464,179,285,20145,43250,2766,249,2489,396,5255,645,_,_,_,33.2,3,6838,0,0
KS,"Phillips County, Kansas",494,207,287,20147,44170,2423,223,2562,175,4985,398,_,_,_,56.3,5,5428,0,0
KS,"Pottawatomie County, Kansas",1992,859,1133,20149,60216,10062,828,10455,805,20517,1633,_,_,_,39.2,9,23298,0,0
KS,"Pratt County, Kansas",1144,511,633,20151,49550,4211,523,4352,446,8563,969,_,_,_,46.2,7,9691,0,0
KS,"Reno County, Kansas",7457,3277,4180,20155,45288,26523,3668,27232,4141,53755,7809,_,_,_,51.4,45,63718,0,0
KS,"Republic County, Kansas",599,248,351,20157,40449,2133,203,2218,154,4351,357,_,_,_,49,4,4725,0,0
KS,"Rice County, Kansas",1365,641,724,20159,48460,4223,745,4250,598,8473,1343,_,_,_,62.7,9,9977,0,0
KS,"Riley County, Kansas",14922,7227,7695,20161,44437,31274,2654,32321,2074,63595,4728,_,_,_,45.2,20,75247,0,0
KS,"Russell County, Kansas",885,442,443,20167,41102,3127,317,3121,299,6248,616,_,_,_,39.9,5,7039,0,0
KS,"Saline County, Kansas",8700,3648,5052,20169,47801,23383,3739,24630,3181,48013,6920,_,_,_,51.8,35,55691,0,0
KS,"Sedgwick County, Kansas",75400,34214,41186,20173,50657,211273,35167,222649,30991,433922,66158,_,_,_,50.3,251,511574,0,0
KS,"Seward County, Kansas",4350,1771,2579,20175,47134,9273,2448,9295,2050,18568,4498,_,_,_,37.1,7,23152,0,0
KS,"Shawnee County, Kansas",26445,12850,13595,20177,50378,74433,10865,81597,8636,156030,19501,_,_,_,49.9,109,178725,0,0
KS,"Sherman County, Kansas",1125,605,520,20181,39029,2553,368,2754,325,5307,693,_,_,_,51.6,5,5983,0,0
KS,"Smith County, Kansas",543,207,336,20183,43848,1693,115,1754,120,3447,235,_,_,_,61.9,4,3704,0,0
KS,"Sumner County, Kansas",2869,1134,1735,20191,50141,10137,1312,10578,1128,20715,2440,_,_,_,49.9,15,23535,0,0
KS,"Washington County, Kansas",649,265,384,20201,45159,2552,262,2526,213,5078,475,_,_,_,42.7,4,5598,0,0
KS,"Wilson County, Kansas",1639,813,826,20205,40306,3690,733,3839,673,7529,1406,_,_,_,36.5,5,8856,0,0
KS,"Woodson County, Kansas",714,328,386,20207,35787,1367,222,1303,295,2670,517,_,_,_,75.6,4,3115,0,0
KS,"Wyandotte County, Kansas",37963,17111,20852,20209,40113,59633,19059,64007,16905,123640,35964,_,_,_,67.4,99,163369,0,0
KY,"Adair County, Kentucky",3789,1677,2112,21001,33362,7610,1513,8237,1191,15847,2704,91.2,21,stable,64.5,15,19027,0,0
KY,"Allen County, Kentucky",3454,1622,1832,21003,41326,8287,1643,8621,1617,16908,3260,82.9,20,stable,67.8,17,20640,0,0
KY,"Anderson County, Kentucky",2223,1071,1152,21005,53974,9563,1019,10211,858,19774,1877,95.1,23,stable,78,18,21979,0,0
KY,"Ballard County, Kentucky",1295,521,774,21007,42244,3513,513,3619,481,7132,994,94.3,11,stable,76.1,9,8212,0,0
KY,"Barren County, Kentucky",8598,3891,4707,21009,38370,17754,2806,19037,2579,36791,5385,106.9,58,stable,73,40,43570,0,0
KY,"Bath County, Kentucky",3122,1519,1603,21011,33483,5097,829,5211,745,10308,1574,109,16,stable,77.4,11,12228,0,0
KY,"Bell County, Kentucky",10233,4422,5811,21013,22443,11077,1888,12279,1896,23356,3784,99.5,37,stable,73.9,28,27337,0,0
KY,"Boone County, Kentucky",10156,4171,5985,21015,66730,55944,4960,58053,4777,113997,9737,86,90,stable,60.1,63,127712,0,0
KY,"Bourbon County, Kentucky",3272,1367,1905,21017,45208,8272,1468,8907,1125,17179,2593,93.4,24,stable,56.2,14,20116,0,0
KY,"Boyd County, Kentucky",9500,3956,5544,21019,42319,19500,2989,21652,2664,41152,5653,92.7,61,stable,65.3,43,48325,0,0
KY,"Boyle County, Kentucky",4291,1972,2319,21021,39704,11987,1657,13140,1313,25127,2970,77.6,29,stable,56.9,21,29809,0,0
KY,"Bracken County, Kentucky",1544,695,849,21023,36327,3834,355,3880,312,7714,667,120.6,12,stable,92.7,9,8321,0,0
KY,"Breathitt County, Kentucky",4366,2095,2271,21025,25817,5669,1065,6027,683,11696,1748,105.7,18,stable,73.2,13,13484,0,0
KY,"Breckinridge County, Kentucky",3422,1525,1897,21027,43479,8348,1409,8807,1218,17155,2627,110.2,29,stable,80,21,20018,0,0
KY,"Bullitt County, Kentucky",7911,3531,4380,21029,55975,34539,3232,36542,2294,71081,5526,90.9,70,stable,59.8,44,78702,0,0
KY,"Butler County, Kentucky",3667,1636,2031,21031,33536,5530,791,5527,772,11057,1563,87.2,14,rising,76.6,12,12938,1,0
KY,"Caldwell County, Kentucky",2544,1119,1425,21033,42537,5306,847,5982,565,11288,1412,103.9,19,stable,88,16,12681,0,0
KY,"Calloway County, Kentucky",8015,3642,4373,21035,37034,15956,2145,17401,2162,33357,4307,79.1,35,stable,57.1,25,38343,0,0
KY,"Campbell County, Kentucky",12883,5671,7212,21037,54621,39050,4835,41623,4503,80673,9338,94.5,93,stable,67.3,65,92066,0,0
KY,"Carlisle County, Kentucky",970,388,582,21039,38829,1999,371,2234,310,4233,681,95.2,7,stable,61.5,5,4874,0,0
KY,"Carroll County, Kentucky",2898,1409,1489,21041,41439,4547,926,4343,777,8890,1703,120.7,15,stable,69.9,9,10699,0,0
KY,"Carter County, Kentucky",4682,2153,2529,21043,36696,11205,2107,11721,1979,22926,4086,103,35,stable,73.5,25,27158,0,0
KY,"Casey County, Kentucky",3969,1878,2091,21045,32341,6323,1419,6646,1235,12969,2654,108.6,23,stable,98.5,21,15808,0,0
KY,"Christian County, Kentucky",13576,5438,8138,21047,39521,26112,4412,30171,4471,56283,8883,84.9,53,falling,62.4,39,73309,0,1
KY,"Clark County, Kentucky",5401,2194,3207,21049,47959,15217,1994,16084,1937,31301,3931,93.4,40,stable,67.4,29,35757,0,0
KY,"Clay County, Kentucky",7732,3730,4002,21051,21549,8527,1318,8879,920,17406,2238,118.6,28,stable,96.5,22,21013,0,0
KY,"Clinton County, Kentucky",2435,1078,1357,21053,28025,4184,760,4569,523,8753,1283,111.7,16,stable,80.5,11,10174,0,0
KY,"Crittenden County, Kentucky",1974,950,1024,21055,35316,3763,740,3854,671,7617,1411,76.6,10,stable,78.8,10,9183,0,0
KY,"Cumberland County, Kentucky",1682,652,1030,21057,32019,2711,582,2831,595,5542,1177,96.4,10,stable,67.9,7,6759,0,0
KY,"Daviess County, Kentucky",14948,6723,8225,21059,45989,41744,4990,45640,4058,87384,9048,110.2,130,stable,78.1,92,99259,0,0
KY,"Edmonson County, Kentucky",2296,971,1325,21061,41710,5339,723,5522,424,10861,1147,85.6,14,stable,70.5,12,12007,0,0
KY,"Elliott County, Kentucky",2079,1023,1056,21063,28224,2965,413,2916,409,5881,822,73.8,8,stable,58.5,6,7648,0,0
KY,"Estill County, Kentucky",4199,1957,2242,21065,29770,5958,1112,6469,811,12427,1923,124.6,24,stable,83.5,16,14375,0,0
KY,"Fayette County, Kentucky",55900,26117,29783,21067,49778,128848,18757,140094,15307,268942,34064,74,206,stable,52.2,145,314488,0,0
KY,"Fleming County, Kentucky",2907,1232,1675,21069,35469,5735,1444,6113,1252,11848,2696,90.5,16,stable,61.1,11,14637,0,0
KY,"Floyd County, Kentucky",11441,5471,5970,21071,30096,15672,3017,17076,2325,32748,5342,149.4,73,falling,98.7,47,37756,0,1
KY,"Franklin County, Kentucky",6990,3195,3795,21073,47964,20632,3089,23049,2051,43681,5140,93,56,stable,75.9,45,50375,0,0
KY,"Fulton County, Kentucky",1641,763,878,21075,28359,2477,379,2656,480,5133,859,112.4,11,stable,88.9,9,6238,0,0
KY,"Gallatin County, Kentucky",1294,589,705,21077,48370,3653,584,3569,651,7222,1235,104,9,stable,83.8,8,8636,0,0
KY,"Garrard County, Kentucky",3653,1729,1924,21079,44243,7132,1188,7409,1144,14541,2332,97.8,21,stable,79.6,16,17237,0,0
KY,"Grant County, Kentucky",4445,1914,2531,21081,44824,10735,1268,10822,1419,21557,2687,95.8,23,stable,64.4,15,24757,0,0
KY,"Graves County, Kentucky",6342,2715,3627,21083,39530,15937,2107,16799,2228,32736,4335,85.8,43,stable,72.8,36,37421,0,0
KY,"Grayson County, Kentucky",6119,2731,3388,21085,35030,10962,1730,11130,1779,22092,3509,129.7,43,stable,87.9,28,26221,0,0
KY,"Green County, Kentucky",2216,1047,1169,21087,34982,4766,672,5029,568,9795,1240,86.4,14,stable,68.4,11,11010,0,0
KY,"Greenup County, Kentucky",6355,2848,3507,21089,45370,15041,2504,16463,2045,31504,4549,107.4,54,stable,71.9,36,36068,0,0
KY,"Hancock County, Kentucky",1360,654,706,21091,50476,4054,375,3828,357,7882,732,81.9,9,stable,81.4,9,8692,0,0
KY,"Hardin County, Kentucky",14886,5818,9068,21093,50765,43690,5003,48278,4751,91968,9754,101.5,104,stable,69.3,71,106439,0,0
KY,"Harlan County, Kentucky",8661,3763,4898,21095,25814,11532,2065,12330,1993,23862,4058,127.6,48,stable,95.3,34,27703,0,0
KY,"Harrison County, Kentucky",4069,1749,2320,21097,35681,7525,1511,8119,1289,15644,2800,95.8,23,stable,65.1,15,18763,0,0
KY,"Hart County, Kentucky",4507,2082,2425,21099,34774,7399,1564,7956,1268,15355,2832,114.5,27,stable,90.2,21,18454,0,0
KY,"Henderson County, Kentucky",8602,3810,4792,21101,41036,19221,2564,21419,2224,40640,4788,97.8,54,stable,67.5,38,46407,0,0
KY,"Henry County, Kentucky",2798,1226,1572,21103,46495,6875,815,6811,876,13686,1691,109.3,21,stable,89.3,17,15620,0,0
KY,"Hickman County, Kentucky",675,284,391,21105,41218,1822,351,2083,264,3905,615,80,6,stable,66.4,5,4612,0,0
KY,"Hopkins County, Kentucky",7799,3301,4498,21107,42346,19300,2689,20665,2855,39965,5544,89.9,55,stable,66.6,41,46222,0,0
KY,"Jackson County, Kentucky",4163,1963,2200,21109,29826,5322,1225,5727,931,11049,2156,118.3,20,stable,104.6,17,13352,0,0
KY,"Jefferson County, Kentucky",121683,54397,67286,21111,48695,317681,42529,350615,36744,668296,79273,89.6,759,stable,60.5,512,763623,0,0
KY,"Jessamine County, Kentucky",9190,4128,5062,21113,50558,21214,2952,22975,2609,44189,5561,89,44,stable,59.7,29,51961,0,0
KY,"Johnson County, Kentucky",5977,2721,3256,21115,35570,9812,1282,10624,1189,20436,2471,113,33,stable,92.5,27,23175,0,0
KY,"Kenton County, Kentucky",23432,10164,13268,21117,54296,70758,8846,74031,7822,144789,16668,90.3,145,stable,65,102,165012,0,0
KY,"Knott County, Kentucky",4308,1935,2373,21119,30411,6791,1117,6837,1073,13628,2190,116.1,23,stable,85.9,17,15693,0,0
KY,"Knox County, Kentucky",10093,4551,5542,21121,26599,13099,2244,14164,1956,27263,4200,125,50,falling,85.9,33,31730,0,1
KY,"Larue County, Kentucky",2460,1058,1402,21123,38578,5839,934,6563,531,12402,1465,74.6,14,stable,60.6,11,14241,0,0
KY,"Laurel County, Kentucky",13588,6216,7372,21125,36020,24302,4516,26170,4023,50472,8539,89.1,61,stable,74.4,50,60094,0,0
KY,"Lawrence County, Kentucky",3548,1619,1929,21127,35935,7013,812,6685,1199,13698,2011,113.9,22,stable,85.1,16,15745,0,0
KY,"Lee County, Kentucky",2003,952,1051,21129,22698,2586,375,2853,480,5439,855,117.7,11,stable,90.8,9,6752,0,0
KY,"Leslie County, Kentucky",3051,1360,1691,21131,25872,4705,562,4739,743,9444,1305,151.8,22,stable,110.3,16,10711,0,0
KY,"Letcher County, Kentucky",6614,3158,3456,21133,30333,10039,1495,10330,1616,20369,3111,118.5,37,stable,96.1,29,23123,0,0
KY,"Lewis County, Kentucky",4151,1885,2266,21135,28630,5802,997,5818,1025,11620,2022,112.6,19,stable,84.1,14,13682,0,0
KY,"Lincoln County, Kentucky",6039,2656,3383,21137,37139,9829,1898,10872,1688,20701,3586,98.5,31,stable,71.6,22,24463,0,0
KY,"Livingston County, Kentucky",1362,518,844,21139,42171,4161,471,4367,333,8528,804,113.1,16,stable,81.6,12,9316,0,0
KY,"Logan County, Kentucky",5103,2411,2692,21141,38570,11222,1890,11565,1903,22787,3793,103.5,36,falling,77.8,26,26910,0,1
KY,"Lyon County, Kentucky",1002,340,662,21143,46931,3120,448,3167,326,6287,774,86.4,12,stable,59.5,8,8306,0,0
KY,"McCracken County, Kentucky",10763,4614,6149,21145,44067,27284,3471,30304,3202,57588,6673,80.9,72,stable,55.6,49,65018,0,0
KY,"McCreary County, Kentucky",6723,3259,3464,21147,19328,7222,1104,7267,829,14489,1933,157.5,31,stable,111.1,22,17878,0,0
KY,"McLean County, Kentucky",1983,1026,957,21149,40770,4194,482,4270,470,8464,952,101.7,14,stable,68.1,9,9512,0,0
KY,"Madison County, Kentucky",16792,7821,8971,21151,42390,36288,4892,39492,4355,75780,9247,91.6,76,stable,73.8,60,87824,0,0
KY,"Magoffin County, Kentucky",3672,1659,2013,21153,28500,5506,977,5635,760,11141,1737,109.7,16,rising,73,10,12808,1,0
KY,"Marion County, Kentucky",3784,1646,2138,21155,38826,8105,1031,8714,824,16819,1855,100.8,22,stable,69.1,15,19365,0,0
KY,"Marshall County, Kentucky",3287,1524,1763,21157,45212,13550,1520,14546,1045,28096,2565,82.9,40,stable,60.9,29,31101,0,0
KY,"Martin County, Kentucky",3896,1753,2143,21159,25795,4729,908,4720,774,9449,1682,145.1,20,stable,109.1,14,12307,0,0
KY,"Mason County, Kentucky",3087,1549,1538,21161,38824,7261,1066,7844,818,15105,1884,123.7,27,stable,86.6,19,17099,0,0
KY,"Meade County, Kentucky",4810,2187,2623,21163,49884,12110,1836,12590,1681,24700,3517,118.1,33,stable,87,24,27924,0,0
KY,"Menifee County, Kentucky",1851,917,934,21165,31503,2721,532,2695,318,5416,850,124.6,11,stable,106,9,6358,0,0
KY,"Mercer County, Kentucky",3862,1709,2153,21167,42083,9137,1331,9758,955,18895,2286,93.3,27,stable,67.2,19,21407,0,0
KY,"Metcalfe County, Kentucky",2158,932,1226,21169,32294,4014,895,4198,784,8212,1679,107.7,15,stable,84,11,9909,0,0
KY,"Monroe County, Kentucky",2937,1363,1574,21171,31045,4672,576,4805,542,9477,1118,106.8,16,stable,84.3,12,10667,0,0
KY,"Montgomery County, Kentucky",6956,3141,3815,21173,39275,11234,1995,11766,1813,23000,3808,94.8,29,stable,68.7,21,27608,0,0
KY,"Morgan County, Kentucky",3249,1464,1785,21175,29707,5158,690,5295,629,10453,1319,98.9,16,stable,81.5,13,13275,0,0
KY,"Muhlenberg County, Kentucky",6000,2750,3250,21177,38961,12821,2172,13643,1647,26464,3819,102.6,42,stable,77.3,32,31183,0,0
KY,"Nelson County, Kentucky",7072,3347,3725,21179,49298,19866,2005,20379,2020,40245,4025,90.4,42,stable,64.2,30,45126,0,0
KY,"Nicholas County, Kentucky",1624,754,870,21181,36097,2885,545,2979,560,5864,1105,106.5,10,stable,89.6,8,7131,0,0
KY,"Ohio County, Kentucky",5208,2466,2742,21183,40189,10653,1198,10556,1345,21209,2543,124.8,38,stable,94.6,28,24216,0,0
KY,"Oldham County, Kentucky",3503,1271,2232,21185,85452,27429,1803,28212,1375,55641,3178,77.2,43,stable,51.6,27,64875,0,0
KY,"Owen County, Kentucky",1780,810,970,21187,41934,4806,448,4930,508,9736,956,91.2,12,stable,50.6,7,10730,0,0
KY,"Owsley County, Kentucky",1710,810,900,21189,20985,1879,247,2108,300,3987,547,148.1,9,stable,118.5,8,4461,0,0
KY,"Pendleton County, Kentucky",2188,875,1313,21191,48353,6614,595,6570,639,13184,1234,97.9,16,stable,67.4,11,14408,0,0
KY,"Perry County, Kentucky",6894,2903,3991,21193,32667,11544,1921,11982,1944,23526,3865,139.7,49,falling,125.6,43,27565,0,1
KY,"Pike County, Kentucky",14256,6146,8110,21195,33183,26905,3723,28765,3303,55670,7026,123,98,stable,85.4,67,61792,0,0
KY,"Powell County, Kentucky",3392,1361,2031,21197,29736,5131,829,5551,714,10682,1543,152.9,23,stable,125.3,18,12269,0,0
KY,"Pulaski County, Kentucky",16497,7900,8597,21199,34790,26787,3975,28664,3411,55451,7386,93.6,80,stable,74.7,63,63782,0,0
KY,"Rockcastle County, Kentucky",4105,1907,2198,21203,31555,7221,929,7651,843,14872,1772,118.1,25,stable,89.2,19,16942,0,0
KY,"Rowan County, Kentucky",5410,2340,3070,21205,36860,9643,1561,10476,1707,20119,3268,92.4,22,stable,69.6,16,23892,0,0
KY,"Russell County, Kentucky",4475,2055,2420,21207,30720,7313,1270,7645,1297,14958,2567,102.4,25,stable,84.1,21,17662,0,0
KY,"Scott County, Kentucky",5332,2152,3180,21209,63027,22340,2276,22960,2365,45300,4641,87.3,37,stable,59.5,24,52420,0,0
KY,"Shelby County, Kentucky",5566,2671,2895,21211,60324,18124,3024,19538,2289,37662,5313,76.6,36,stable,47.8,22,45632,0,0
KY,"Simpson County, Kentucky",3473,1486,1987,21213,39679,7182,1324,7973,907,15155,2231,106.5,22,stable,81.7,17,18006,0,0
KY,"Spencer County, Kentucky",1466,577,889,21215,63000,8119,615,8069,651,16188,1266,84.8,15,stable,59,10,17894,0,0
KY,"Taylor County, Kentucky",5658,2390,3268,21217,33340,9975,1923,11125,1615,21100,3538,100.2,32,stable,81.6,26,25420,0,0
KY,"Todd County, Kentucky",2277,927,1350,21219,40497,4872,1197,4982,1241,9854,2438,83.1,12,stable,65.1,9,12531,0,0
KY,"Trigg County, Kentucky",2500,1030,1470,21221,44083,5665,1274,6222,1005,11887,2279,94.6,20,stable,80.6,17,14233,0,0
KY,"Trimble County, Kentucky",1486,737,749,21223,47409,3727,636,3934,486,7661,1122,113.2,12,stable,91.9,9,8769,0,0
KY,"Union County, Kentucky",4091,2171,1920,21225,40120,6386,1340,6497,760,12883,2100,106.4,17,stable,78.2,13,15050,0,0
KY,"Warren County, Kentucky",21047,9159,11888,21227,44911,49575,7636,54292,6175,103867,13811,91.3,100,stable,65.5,70,122851,0,0
KY,"Washington County, Kentucky",2034,969,1065,21229,40976,5190,641,5345,609,10535,1250,80.5,12,stable,60.6,9,12063,0,0
KY,"Wayne County, Kentucky",5477,2505,2972,21231,28573,8652,1393,9154,1148,17806,2541,101.7,28,stable,79.5,22,20464,0,0
KY,"Webster County, Kentucky",2296,1117,1179,21233,38917,5656,845,5850,713,11506,1558,109.1,19,stable,73.7,13,13170,0,0
KY,"Whitley County, Kentucky",8871,4030,4841,21235,31014,14768,2377,15823,2205,30591,4582,122.4,50,stable,95.6,39,36129,0,0
KY,"Wolfe County, Kentucky",3058,1537,1521,21237,20504,3089,443,3194,410,6283,853,118.3,11,stable,77.6,7,7259,0,0
KY,"Woodford County, Kentucky",3259,1279,1980,21239,58750,10802,1350,12086,961,22888,2311,68.2,20,stable,51.9,15,25793,0,0
LA,"Acadia Parish, Louisiana",12539,4702,7837,22001,37649,25052,4501,26321,5380,51373,9881,79.6,53,stable,68.6,46,62577,0,0
LA,"Allen Parish, Louisiana",3501,1568,1933,22003,40948,9085,1517,9271,1456,18356,2973,71.2,19,stable,58.4,16,25683,0,0
LA,"Ascension Parish, Louisiana",13447,5551,7896,22005,70551,49740,6573,51245,6347,100985,12920,68.6,63,stable,58.8,51,119455,0,0
LA,"Assumption Parish, Louisiana",3643,1673,1970,22007,49167,9365,1730,10035,1732,19400,3462,77.8,21,stable,62.9,17,22842,0,0
LA,"Avoyelles Parish, Louisiana",8750,3408,5342,22009,33739,14267,3471,16338,3711,30605,7182,85.2,42,stable,66.7,33,41103,0,0
LA,"Beauregard Parish, Louisiana",7137,3103,4034,22011,45969,14324,3286,14852,2707,29176,5993,76.4,30,stable,59.5,23,36462,0,0
LA,"Bienville Parish, Louisiana",3754,1397,2357,22013,32876,5355,1163,6032,1103,11387,2266,82,16,stable,63.3,12,13786,0,0
LA,"Bossier Parish, Louisiana",17303,7402,9901,22015,52892,49219,7780,53840,7722,103059,15502,75.3,91,stable,54.1,65,125175,0,0
LA,"Caddo Parish, Louisiana",53752,23393,30359,22017,41234,98254,19517,111467,20545,209721,40062,69,201,stable,54.8,159,251460,0,0
LA,"Calcasieu Parish, Louisiana",32864,13822,19042,22019,45312,78600,15365,84661,14896,163261,30261,68.4,145,stable,58.1,121,198788,0,0
LA,"Caldwell Parish, Louisiana",2053,876,1177,22021,33294,3588,1273,3742,909,7330,2182,95.2,12,stable,76.8,10,9993,0,0
LA,"Cameron Parish, Louisiana",650,317,333,22023,64231,2885,375,3098,336,5983,711,64.1,5,stable,42.4,3,6817,0,0
LA,"Catahoula Parish, Louisiana",1890,872,1018,22025,34904,3492,1086,3512,1194,7004,2280,93,12,stable,66.1,8,10147,0,0
LA,"Claiborne Parish, Louisiana",4058,2023,2035,22027,32072,6309,1419,5875,1103,12184,2522,69.5,15,stable,44.2,10,16295,0,0
LA,"Concordia Parish, Louisiana",5598,2400,3198,22029,29654,6436,2106,6914,2963,13350,5069,76.7,19,stable,59.6,15,20142,0,0
LA,"De Soto Parish, Louisiana",7059,3061,3998,22031,41468,10910,1898,11889,2111,22799,4009,80.7,27,stable,52.7,18,27052,0,0
LA,"East Baton Rouge Parish, Louisiana",85254,37081,48173,22033,49285,182247,29615,203061,26795,385308,56410,56.4,240,stable,46.9,199,446753,0,0
LA,"East Carroll Parish, Louisiana",2903,1374,1529,22035,21099,2184,704,2549,627,4733,1331,98,8,stable,72.6,6,7307,0,0
LA,"East Feliciana Parish, Louisiana",3317,1569,1748,22037,45520,7029,1171,7838,1130,14867,2301,61.1,15,stable,60.4,14,19696,0,0
LA,"Evangeline Parish, Louisiana",8373,3718,4655,22039,30009,12886,2366,14036,2317,26922,4683,81.8,30,stable,70.6,26,33743,0,0
LA,"Franklin Parish, Louisiana",5847,2294,3553,22041,30275,6763,2057,8079,2208,14842,4265,77.2,21,stable,47.9,13,20410,0,0
LA,"Grant Parish, Louisiana",3460,1459,2001,22043,39914,7766,1456,8385,1330,16151,2786,100.8,24,stable,71.7,16,22343,0,0
LA,"Iberia Parish, Louisiana",14277,6094,8183,22045,45261,29216,6262,31899,5736,61115,11998,78.2,60,stable,66.3,50,74103,0,0
LA,"Iberville Parish, Louisiana",5612,2473,3139,22047,45117,12326,2175,13307,1618,25633,3793,92.2,34,stable,67,24,33095,0,0
LA,"Jackson Parish, Louisiana",3981,1799,2182,22049,38029,6201,1155,6669,1008,12870,2163,80.5,18,stable,70.7,15,15858,0,0
LA,"Jefferson Parish, Louisiana",72319,30773,41546,22051,47947,170170,38834,190812,31948,360982,70782,67.4,340,stable,52.3,262,436275,0,0
LA,"Jefferson Davis Parish, Louisiana",6462,2713,3749,22053,39063,13196,1961,13402,2304,26598,4265,81.8,31,stable,70.1,27,31439,0,0
LA,"Lafayette Parish, Louisiana",36346,15225,21121,22055,51869,95586,16284,100459,17188,196045,33472,69.9,145,stable,52,107,240098,0,0
LA,"Lafourche Parish, Louisiana",14117,5730,8387,22057,51030,40417,6919,42188,7112,82605,14031,70.9,73,stable,59.9,62,98325,0,0
LA,"LaSalle Parish, Louisiana",2857,1184,1673,22059,37310,5609,1111,5849,1087,11458,2198,87.6,16,falling,62.3,11,14974,0,1
LA,"Lincoln Parish, Louisiana",14146,6360,7786,22061,33467,18702,3888,20323,3822,39025,7710,60.7,27,stable,45.9,20,47774,0,0
LA,"Livingston Parish, Louisiana",19086,7960,11126,22063,58251,54967,10265,58238,9526,113205,19791,81.6,98,stable,66.4,77,137788,0,0
LA,"Madison Parish, Louisiana",3962,1840,2122,22065,23854,3300,1738,3621,1747,6921,3485,66.7,9,stable,41.3,5,11514,0,0
LA,"Morehouse Parish, Louisiana",7432,3212,4220,22067,28003,9869,2442,11441,2459,21310,4901,76.1,27,stable,52.7,18,26395,0,0
LA,"Natchitoches Parish, Louisiana",11208,4921,6287,22069,31345,15049,3127,16951,3484,32000,6611,66,29,stable,52.7,23,39179,0,0
LA,"Orleans Parish, Louisiana",98823,42998,55825,22071,36792,144150,32246,167332,27871,311482,60117,67.6,242,stable,53.4,185,389617,0,0
LA,"Ouachita Parish, Louisiana",36312,14458,21854,22073,37754,55010,13804,65499,15045,120509,28849,78.3,126,stable,62,99,156761,0,0
LA,"Plaquemines Parish, Louisiana",3775,1348,2427,22075,50314,9586,1469,10469,1260,20055,2729,70.4,17,stable,51.6,12,23495,0,0
LA,"Pointe Coupee Parish, Louisiana",4368,1876,2492,22077,43825,8902,1807,9933,1729,18835,3536,53.5,17,stable,44.1,13,22251,0,0
LA,"Rapides Parish, Louisiana",26645,11724,14921,22079,40734,51678,10140,57797,9853,109475,19993,68.9,103,stable,53.7,81,132141,0,0
LA,"Red River Parish, Louisiana",1937,803,1134,22081,38000,3476,734,3741,775,7217,1509,57.9,6,stable,39.4,4,8593,0,0
LA,"Richland Parish, Louisiana",4154,1825,2329,22083,36421,6428,3106,7524,2868,13952,5974,79,19,stable,57.5,14,20523,0,0
LA,"Sabine Parish, Louisiana",4626,1836,2790,22085,38828,9729,2123,9862,2117,19591,4240,66.5,23,falling,59.5,20,24186,0,1
LA,"St. Bernard Parish, Louisiana",8209,3529,4680,22087,42753,17811,3166,18950,2585,36761,5751,97.4,33,stable,79.8,26,45408,0,0
LA,"St. Charles Parish, Louisiana",6152,2412,3740,22089,59990,21539,3573,23413,3456,44952,7029,71.2,36,stable,58.8,29,52812,0,0
LA,"St. Helena Parish, Louisiana",2854,1309,1545,22091,35437,3913,1245,4593,943,8506,2188,64.3,9,stable,67.1,9,10567,0,0
LA,"St. James Parish, Louisiana",3841,1845,1996,22093,51107,8688,1575,9829,1335,18517,2910,58,14,stable,53.3,13,21567,0,0
LA,"St. John the Baptist Parish, Louisiana",7893,3390,4503,22095,50921,17705,3182,19606,2968,37311,6150,61.6,27,stable,56.3,25,43626,0,0
LA,"St. Landry Parish, Louisiana",22970,9790,13180,22097,32625,33611,6006,36207,6717,69818,12723,80.3,76,stable,61.2,58,83848,0,0
LA,"St. Martin Parish, Louisiana",9388,3920,5468,22099,42794,22517,3509,22724,4110,45241,7619,75.1,42,stable,61.5,34,53835,0,0
LA,"St. Mary Parish, Louisiana",11746,4967,6779,22101,40781,20511,5130,22112,4804,42623,9934,66.6,40,stable,53.4,33,52810,0,0
LA,"St. Tammany Parish, Louisiana",27482,11568,15914,22103,62137,100907,15203,110031,14275,210938,29478,67.3,179,stable,51.5,135,250088,0,0
LA,"Tangipahoa Parish, Louisiana",26962,11734,15228,22105,41302,49445,11132,54218,9950,103663,21082,79.3,100,stable,62.4,77,128755,0,0
LA,"Tensas Parish, Louisiana",1685,731,954,22107,22940,1437,819,1794,707,3231,1526,58.5,4,stable,58.6,4,4740,0,0
LA,"Terrebonne Parish, Louisiana",21627,9182,12445,22109,47826,45137,9743,47124,9504,92261,19247,76.2,86,stable,57.1,64,113972,0,0
LA,"Union Parish, Louisiana",6166,2682,3484,22111,34992,9243,1520,9346,2002,18589,3522,78.9,24,stable,73.6,22,22477,0,0
LA,"Vermilion Parish, Louisiana",10379,4185,6194,22113,45374,23925,4489,26220,4020,50145,8509,77.5,49,stable,56.5,36,59875,0,0
LA,"Vernon Parish, Louisiana",7403,3280,4123,22115,46312,19463,2999,21583,2744,41046,5743,91.7,39,stable,72.1,30,50803,0,0
LA,"Washington Parish, Louisiana",11811,5364,6447,22117,30705,17546,3722,19486,4016,37032,7738,92,53,stable,67.4,39,46371,0,0
LA,"Webster Parish, Louisiana",9327,4117,5210,22119,33681,15408,3646,17022,3617,32430,7263,86.3,46,stable,55.6,30,40021,0,0
LA,"West Baton Rouge Parish, Louisiana",4662,1883,2779,22121,53703,9882,1667,11267,1171,21149,2838,71.5,18,stable,54.9,13,25490,0,0
LA,"West Carroll Parish, Louisiana",2746,1066,1680,22123,31926,3298,1763,3779,1842,7077,3605,78.5,12,stable,70.8,11,11293,0,0
LA,"West Feliciana Parish, Louisiana",1914,1016,898,22125,56685,6066,805,4546,575,10612,1380,80.1,14,stable,56.9,10,15385,0,0
LA,"Winn Parish, Louisiana",3466,1506,1960,22127,31087,5058,1136,5731,1183,10789,2319,80.3,15,stable,66.1,12,14568,0,0
MA,"Barnstable County, Massachusetts",18392,8191,10201,25001,63251,96016,5058,106883,4331,202899,9389,60,247,stable,41.5,175,214333,0,0
MA,"Berkshire County, Massachusetts",16038,6834,9204,25003,49956,58717,2525,64310,1472,123027,3997,70,135,stable,47.9,95,127828,0,0
MA,"Bristol County, Massachusetts",68016,29385,38631,25005,56842,251666,12617,273204,8304,524870,20921,72.9,476,stable,49.6,326,556772,0,0
MA,"Dukes County, Massachusetts",1970,802,1168,25007,64222,7430,957,8134,416,15564,1373,53.7,13,stable,42.2,10,17299,0,0
MA,"Essex County, Massachusetts",85417,35457,49960,25009,69068,346008,17841,381455,11050,727463,28891,67.5,602,stable,43.3,390,776043,0,0
MA,"Franklin County, Massachusetts",8210,3508,4702,25011,55221,32927,1385,35098,984,68025,2369,52.1,50,stable,36.3,35,70601,0,0
MA,"Hampden County, Massachusetts",79308,34517,44791,25013,50461,211241,11563,233061,6691,444302,18254,67.8,368,stable,49.5,271,470690,0,0
MA,"Hampshire County, Massachusetts",20317,9564,10753,25015,61368,71865,2788,82499,2255,154364,5043,52.5,90,stable,39.9,68,161292,0,0
MA,"Middlesex County, Massachusetts",124958,53601,71357,25017,85118,718895,30371,771113,20090,1490008,50461,61.8,1031,falling,42.5,713,1585139,0,1
MA,"Nantucket County, Massachusetts",1205,657,548,25019,84057,5049,506,4666,283,9715,789,52.8,6,stable,42.7,5,10925,0,0
MA,"Norfolk County, Massachusetts",44199,17778,26421,25021,88262,315500,8590,348517,6448,664017,15038,63,511,stable,42.8,354,696023,0,0
MA,"Plymouth County, Massachusetts",40309,17589,22720,25023,75459,230787,9501,249253,6633,480040,16134,72.4,430,stable,49.6,292,510393,0,0
MA,"Suffolk County, Massachusetts",148278,64005,84273,25025,55044,339121,23427,375290,14000,714411,37427,69.7,448,falling,45.6,292,778121,0,1
MA,"Worcester County, Massachusetts",92288,40222,52066,25027,65313,375789,16106,397311,9771,773100,25877,69.8,616,stable,50.1,439,818963,0,0
MD,"Allegany County, Maryland",11927,5722,6205,24001,40551,30584,2908,32601,2070,63185,4978,78.1,82,stable,45.7,48,72528,0,0
MD,"Anne Arundel County, Maryland",31573,13598,17975,24003,89860,240091,19346,260900,14834,500991,34180,64.3,364,stable,50.1,277,564195,0,0
MD,"Baltimore County, Maryland",75464,30881,44583,24005,67095,349705,36042,399264,29786,748969,65828,67.6,661,stable,47.8,471,831128,0,0
MD,"Calvert County, Maryland",5207,2044,3163,24009,95828,40547,3060,42835,2344,83382,5404,64.7,57,stable,49.4,43,90595,0,0
MD,"Caroline County, Maryland",5086,2254,2832,24011,52465,13480,2162,15141,1486,28621,3648,75.1,28,stable,56.7,22,32579,0,0
MD,"Carroll County, Maryland",9205,4085,5120,24013,85385,77013,4409,80583,3425,157596,7834,61,117,stable,47.9,90,167627,0,0
MD,"Cecil County, Maryland",10179,4664,5515,24015,66396,45549,4270,47305,3698,92854,7968,79.2,85,stable,64.4,69,102382,0,0
MD,"Charles County, Maryland",11905,4933,6972,24017,90607,67034,4660,75125,3317,142159,7977,55.4,74,stable,47.1,61,156118,0,0
MD,"Dorchester County, Maryland",5275,2146,3129,24019,47093,13800,1515,15552,1228,29352,2743,73.1,34,stable,62,29,32384,0,0
MD,"Frederick County, Maryland",16204,7194,9010,24021,83700,108742,8968,114221,7176,222963,16144,52.7,124,stable,40.6,95,245322,0,0
MD,"Garrett County, Maryland",3615,1673,1942,24023,45432,12834,1649,13368,1480,26202,3129,49.5,21,stable,46.3,19,29460,0,0
MD,"Harford County, Maryland",19854,8342,11512,24025,80465,113060,7086,120857,5276,233917,12362,68.6,184,rising,49.9,131,250290,1,0
MD,"Howard County, Maryland",15759,6684,9075,24027,110238,137570,9750,145908,8370,283478,18120,44.4,118,stable,28.8,74,313414,0,0
MD,"Kent County, Maryland",2051,825,1226,24029,58147,8298,942,9733,599,18031,1541,61.1,20,stable,53.4,18,19787,0,0
MD,"Montgomery County, Maryland",67820,28612,39208,24031,99435,430903,54617,474753,48905,905656,103522,35.4,371,falling,25,263,1040116,0,1
MD,"Prince George's County, Maryland",84018,36085,47933,24033,74260,355547,69865,408095,52586,763642,122451,46.6,361,falling,40,299,909535,0,1
MD,"Queen Anne's County, Maryland",3588,1721,1867,24035,85963,22094,1470,23452,999,45546,2469,63.9,39,stable,47.1,27,48904,0,0
MD,"St. Mary's County, Maryland",8384,3098,5286,24037,86987,48738,3615,51331,3219,100069,6834,68.8,68,stable,54,52,111413,0,0
MD,"Somerset County, Maryland",4681,1834,2847,24039,35154,8510,1033,10465,1225,18975,2258,95.9,29,stable,70.4,21,25768,0,0
MD,"Talbot County, Maryland",4202,1493,2709,24041,58228,15681,1921,18088,1719,33769,3640,51.1,34,stable,40,28,37512,0,0
MD,"Washington County, Maryland",18094,7436,10658,24043,56228,62393,6419,66780,5372,129173,11791,71.8,126,stable,53.5,94,149585,0,0
MD,"Wicomico County, Maryland",15493,6604,8889,24045,52278,41662,5754,48196,4245,89858,9999,79.4,87,falling,59.7,65,102370,0,1
MD,"Worcester County, Maryland",5567,2436,3131,24047,56773,21853,2792,24194,2068,46047,4860,70.2,63,stable,59.8,54,51540,0,0
MD,"Baltimore city, Maryland",141654,62133,79521,24510,42241,249644,36380,299583,27012,549227,63392,80.9,512,stable,61.8,388,621849,0,0
ME,"Androscoggin County, Maine",16332,7347,8985,23001,47537,46709,5390,50154,4136,96863,9526,78.1,101,stable,60.8,80,107233,0,0
ME,"Aroostook County, Maine",12608,5761,6847,23003,36923,29842,4255,31765,3092,61607,7347,84.1,92,stable,62.2,68,68628,0,0
ME,"Cumberland County, Maine",32339,15055,17284,23005,60051,123850,13135,135529,10366,259379,23501,68.3,237,stable,48.9,169,289977,0,0
ME,"Franklin County, Maine",4318,1971,2347,23007,42811,13230,1633,13653,1736,26883,3369,57.7,24,stable,48.3,20,29991,0,0
ME,"Hancock County, Maine",7196,3075,4121,23009,47030,22315,4190,24230,3497,46545,7687,68.8,56,stable,47.1,39,54659,0,0
ME,"Kennebec County, Maine",16256,7316,8940,23011,46917,51871,6022,57298,4550,109169,10572,75.6,121,stable,57.3,91,119980,0,0
ME,"Knox County, Maine",4304,2232,2072,23013,50693,15898,2827,17774,2158,33672,4985,72,45,stable,49.2,31,39855,0,0
ME,"Lincoln County, Maine",4073,1809,2264,23015,50462,14128,2238,15508,1775,29636,4013,50.8,30,stable,43.8,26,33969,0,0
ME,"Oxford County, Maine",9911,4357,5554,23017,40630,24711,3543,25809,2981,50520,6524,85.6,70,stable,60.9,50,57202,0,0
ME,"Penobscot County, Maine",24933,11157,13776,23019,44271,65459,9179,69243,7781,134702,16960,84.4,160,stable,60.4,116,152692,0,0
ME,"Piscataquis County, Maine",3520,1643,1877,23021,37495,7265,1242,7529,985,14794,2227,75.8,21,stable,56.3,15,16931,0,0
ME,"Sagadahoc County, Maine",4200,1710,2490,23023,53298,15131,1641,16850,1267,31981,2908,66,31,stable,49.3,23,35149,0,0
ME,"Somerset County, Maine",8907,4162,4745,23025,40066,21672,3489,23389,2515,45061,6004,84.3,60,stable,57.9,41,51113,0,0
ME,"Waldo County, Maine",6243,2895,3348,23027,44082,16656,2339,17567,2185,34223,4524,83.6,44,stable,56.5,29,39155,0,0
ME,"Washington County, Maine",5946,2598,3348,23029,38083,13241,2331,14250,1811,27491,4142,87.8,45,stable,61.1,31,31625,0,0
ME,"York County, Maine",19192,7672,11520,23031,57919,85969,10381,94299,7360,180268,17741,71.7,187,stable,48.3,127,201169,0,0
MI,"Alcona County, Michigan",1575,709,866,26001,38033,4712,568,4643,531,9355,1099,66.2 #,15,stable,68.2,17,10349,0,0
MI,"Alger County, Michigan",1213,635,578,26003,39300,3733,590,3747,429,7480,1019,48.6 #,8,stable,48.4,8,9383,0,0
MI,"Allegan County, Michigan",14185,6447,7738,26005,54264,50610,5289,51742,4477,102352,9766,53.7 #,70,stable,46.6,59,114625,0,0
MI,"Alpena County, Michigan",4898,2193,2705,26007,38829,12241,1820,13037,1605,25278,3425,77.1 #,35,falling,54.3,25,28803,0,1
MI,"Antrim County, Michigan",3316,1451,1865,26009,46845,10140,1370,10359,1232,20499,2602,59.1 #,24,stable,47,19,23154,0,0
MI,"Arenac County, Michigan",3013,1512,1501,26011,38307,6758,977,6890,630,13648,1607,104.9 #,27,stable,83.8,21,15261,0,0
MI,"Baraga County, Michigan",992,423,569,26013,39803,2832,242,3020,293,5852,535,74.9 #,9,stable,58.8,7,8575,0,0
MI,"Barry County, Michigan",6377,2907,3470,26015,55064,26953,2512,27124,2071,54077,4583,45.3 #,34,stable,43.8,33,59314,0,0
MI,"Bay County, Michigan",15804,7485,8319,26017,45583,46672,5401,49948,3721,96620,9122,60.7 #,87,stable,51.3,74,105659,0,0
MI,"Benzie County, Michigan",1989,936,1053,26019,47388,7415,1202,7759,873,15174,2075,71.4 #,21,stable,63.8,18,17457,0,0
MI,"Berrien County, Michigan",26719,11545,15174,26021,44993,66019,9480,70814,8026,136833,17506,69.7 #,143,stable,53.2,109,154636,0,0
MI,"Branch County, Michigan",7310,3527,3783,26023,44373,17948,2654,18762,2211,36710,4865,61.6 #,34,stable,48.6,27,43664,0,0
MI,"Calhoun County, Michigan",22931,10265,12666,26025,42520,57482,7460,62320,5876,119802,13336,71.1 #,119,stable,58.9,99,134314,0,0
MI,"Cass County, Michigan",7576,3689,3887,26027,46570,22876,3208,23121,2612,45997,5820,56.1 #,39,stable,52.8,36,51657,0,0
MI,"Charlevoix County, Michigan",3181,1431,1750,26029,46554,11309,1423,12008,1126,23317,2549,61.7 #,24,stable,45.1,18,26238,0,0
MI,"Cheboygan County, Michigan",4595,2023,2572,26031,40219,10755,1840,11273,1519,22028,3359,73.6 #,32,stable,62.7,27,25427,0,0
MI,"Chippewa County, Michigan",6485,3312,3173,26033,41993,15235,2328,15554,1781,30789,4109,73.6 #,34,stable,59.3,27,38033,0,0
MI,"Clare County, Michigan",7895,3545,4350,26035,33015,12679,2275,13375,2058,26054,4333,75.6 #,37,stable,64.6,31,30553,0,0
MI,"Clinton County, Michigan",8933,4098,4835,26037,60909,34356,3186,36596,2139,70952,5325,36.6 #,31,stable,38.9,33,77390,0,0
MI,"Crawford County, Michigan",2073,977,1096,26039,41743,6315,630,6190,578,12505,1208,73 #,17,stable,67.1,16,13801,0,0
MI,"Delta County, Michigan",6227,2966,3261,26041,42031,15893,2084,16433,1892,32326,3976,63.2 #,36,stable,47.7,27,36377,0,0
MI,"Dickinson County, Michigan",3523,1489,2034,26043,43779,11386,1309,12033,912,23419,2221,50.7 #,20,stable,46.5,19,25788,0,0
MI,"Eaton County, Michigan",11524,5064,6460,26045,54993,47705,4843,51387,3728,99092,8571,51.8 #,68,stable,48.3,62,108801,0,0
MI,"Emmet County, Michigan",3506,1504,2002,26047,51018,14287,1872,15012,1507,29299,3379,63 #,29,stable,53.8,25,33161,0,0
MI,"Genesee County, Michigan",85696,38849,46847,26049,42327,178891,20287,199440,14671,378331,34958,80.3 #,399,stable,60.6,298,410849,0,0
MI,"Gladwin County, Michigan",5211,2382,2829,26051,38021,10845,1845,11109,1476,21954,3321,79 #,35,stable,62.8,28,25164,0,0
MI,"Gogebic County, Michigan",2859,1339,1520,26053,35686,6260,943,6147,942,12407,1885,63.1 #,17,stable,57,16,15431,0,0
MI,"Grand Traverse County, Michigan",9575,4520,5055,26055,52950,37680,4728,41452,3904,79132,8632,66.4 #,74,stable,40.8,45,91636,0,0
MI,"Gratiot County, Michigan",6792,2868,3924,26057,41912,16372,1837,17609,1700,33981,3537,66 #,33,stable,54.1,27,41540,0,0
MI,"Hillsdale County, Michigan",8982,4302,4680,26059,41961,19711,3065,20196,2809,39907,5874,62.4 #,39,stable,59.1,36,45941,0,0
MI,"Houghton County, Michigan",7406,4283,3123,26061,37776,17670,2056,15133,1373,32803,3429,49.6 #,21,stable,43.9,19,36380,0,0
MI,"Huron County, Michigan",4486,2093,2393,26063,42161,14149,1771,14664,1337,28813,3108,56.8 #,31,stable,45.4,25,31883,0,0
MI,"Ingham County, Michigan",59468,27305,32163,26065,45679,123123,13582,135036,10043,258159,23625,58.8 #,155,stable,41.6,109,286085,0,0
MI,"Ionia County, Michigan",9084,4395,4689,26067,49124,27175,3133,27785,2216,54960,5349,63.5 #,43,stable,51.1,33,64223,0,0
MI,"Iosco County, Michigan",4395,2005,2390,26069,37317,10898,1614,11358,1209,22256,2823,65.6 #,34,stable,54.9,28,25345,0,0
MI,"Iron County, Michigan",1749,875,874,26071,33663,4921,649,5149,506,10070,1155,60.4 #,15,stable,50,12,11348,0,0
MI,"Isabella County, Michigan",19390,9228,10162,26073,39377,29705,4265,32384,3727,62089,7992,69.2 #,41,stable,57.8,33,70698,0,0
MI,"Jackson County, Michigan",25464,11251,14213,26075,46326,66927,7612,70651,6782,137578,14394,82 #,157,stable,61.9,119,159494,0,0
MI,"Kalamazoo County, Michigan",45473,20808,24665,26077,47476,111892,12752,120882,9318,232774,22070,61.3 #,163,stable,47.5,126,260263,0,0
MI,"Kalkaska County, Michigan",2875,1379,1496,26079,40534,7510,1215,7382,1061,14892,2276,73.4 #,18,stable,72.7,17,17260,0,0
MI,"Kent County, Michigan",93489,42845,50644,26081,53063,270413,33224,289867,25135,560280,58359,59.3 #,353,stable,41.3,247,636369,0,0
MI,"Lake County, Michigan",3164,1509,1655,26085,30439,4793,755,4941,570,9734,1325,77.4 #,16,stable,66.8,14,11424,0,0
MI,"Lapeer County, Michigan",9152,4261,4891,26087,52996,38764,4435,39708,3818,78472,8253,71.9 #,76,stable,56.6,58,88373,0,0
MI,"Leelanau County, Michigan",2245,1099,1146,26089,56189,9505,1155,10196,775,19701,1930,35.7 #,14,stable,31.5,13,21981,0,0
MI,"Lenawee County, Michigan",13427,6044,7383,26091,48043,42704,4735,44449,3837,87153,8572,60 #,73,stable,48.8,60,98573,0,0
MI,"Livingston County, Michigan",10895,4813,6082,26093,75204,85073,6726,86466,5495,171539,12221,54.6 #,108,stable,44.2,86,187316,0,0
MI,"Luce County, Michigan",1059,453,606,26095,37088,2435,347,2435,217,4870,564,84 #,8,stable,56.7,6,6415,0,0
MI,"Mackinac County, Michigan",1730,818,912,26097,38434,4638,839,4680,745,9318,1584,61.9 #,12,stable,46.6,9,10890,0,0
MI,"Macomb County, Michigan",106546,46437,60109,26099,54582,368100,43732,401222,35114,769322,78846,75.2,756,falling,52.2,527,864840,0,1
MI,"Manistee County, Michigan",3918,1767,2151,26101,41395,9995,1585,10661,1055,20656,2640,67.3 #,27,stable,51.4,21,24461,0,0
MI,"Marquette County, Michigan",10689,4951,5738,26103,45409,28379,4020,30126,2915,58505,6935,64.9 #,54,stable,50.5,42,67215,0,0
MI,"Mason County, Michigan",4861,2242,2619,26105,42024,12285,1895,12820,1407,25105,3302,54.9 #,24,stable,56.9,25,28783,0,0
MI,"Mecosta County, Michigan",9338,4257,5081,26107,41889,18956,2724,19265,2128,38221,4852,69.4 #,36,stable,52.3,27,43067,0,0
MI,"Menominee County, Michigan",3774,1517,2257,26109,40373,10669,1146,10471,1131,21140,2277,50.1 #,19,stable,49.3,19,23548,0,0
MI,"Midland County, Michigan",10955,4988,5967,26111,54059,37251,3602,39026,3132,76277,6734,58 #,60,stable,40.3,42,83632,0,0
MI,"Missaukee County, Michigan",2490,1153,1337,26113,41098,6595,1016,6522,738,13117,1754,73.3 #,15,stable,54.3,11,14903,0,0
MI,"Monroe County, Michigan",16860,7388,9472,26115,55653,67649,6066,70833,5009,138482,11075,63.6 #,115,stable,57,101,149568,0,0
MI,"Montcalm County, Michigan",10924,4760,6164,26117,41584,26455,3758,27230,3094,53685,6852,75.3 #,56,stable,59.2,44,62945,0,0
MI,"Montmorency County, Michigan",1568,611,957,26119,36250,4024,700,4066,499,8090,1199,78.6 #,15,stable,56.1,11,9259,0,0
MI,"Muskegon County, Michigan",31550,14092,17458,26121,42829,72693,8208,79276,6412,151969,14620,77.6 #,155,stable,58.4,118,172790,0,0
MI,"Newaygo County, Michigan",8605,3978,4627,26123,43693,21189,2645,21487,2188,42676,4833,63.8 #,40,stable,60.7,38,47948,0,0
MI,"Oakland County, Michigan",123086,54727,68359,26125,67465,540991,53142,583675,45780,1124666,98922,62.8,866,stable,41,567,1242304,0,0
MI,"Oceana County, Michigan",5285,2524,2761,26127,41617,11339,1861,11398,1458,22737,3319,51.2 #,19,stable,46.3,17,26105,0,0
MI,"Ogemaw County, Michigan",4537,2019,2518,26129,36063,9179,1263,9466,1044,18645,2307,73.2 #,27,stable,58.9,22,20937,0,0
MI,"Ontonagon County, Michigan",967,464,503,26131,34459,2755,457,2664,358,5419,815,71.1 #,10,falling,55.4,8,6007,0,1
MI,"Osceola County, Michigan",5032,2248,2784,26133,38999,9666,1847,10119,1340,19785,3187,97 #,31,stable,64.2,21,23058,0,0
MI,"Oscoda County, Michigan",1656,770,886,26135,33021,3544,791,3402,664,6946,1455,87.3 #,14,stable,66,10,8251,0,0
MI,"Otsego County, Michigan",3270,1318,1952,26137,48917,10454,1369,11063,1070,21517,2439,68.2 #,23,falling,61.2,21,24253,0,1
MI,"Ottawa County, Michigan",27361,12381,14980,26139,58989,124049,9990,129902,7876,253951,17866,39.3 #,105,stable,32.1,86,279955,0,0
MI,"Presque Isle County, Michigan",1761,792,969,26141,41213,5692,745,5811,629,11503,1374,57.9 #,15,stable,60.2,16,12841,0,0
MI,"Roscommon County, Michigan",4885,2222,2663,26143,35133,10354,1533,10736,1218,21090,2751,81 #,41,stable,60.1,30,23898,0,0
MI,"Saginaw County, Michigan",34825,15792,19033,26145,43042,83873,8958,92158,8175,176031,17133,69.1 #,173,stable,50.5,127,193307,0,0
MI,"St. Clair County, Michigan",23128,10571,12557,26147,49730,70567,8439,73895,6338,144462,14777,69.5 #,141,falling,59.5,122,159875,0,1
MI,"St. Joseph County, Michigan",10319,4684,5635,26149,44449,26216,3753,27574,2924,53790,6677,65.7 #,49,stable,53,40,61018,0,0
MI,"Sanilac County, Michigan",6522,2816,3706,26151,41100,17714,2968,18524,2512,36238,5480,50.2 #,30,stable,47.6,29,41475,0,0
MI,"Schoolcraft County, Michigan",1735,831,904,26153,34118,3498,543,3717,421,7215,964,70.8 #,10,stable,62,9,8173,0,0
MI,"Shiawassee County, Michigan",9790,4325,5465,26155,48233,29932,3966,31666,3101,61598,7067,77.9 #,67,stable,59,51,68619,0,0
MI,"Tuscola County, Michigan",8317,3963,4354,26157,43768,23607,3046,24523,2326,48130,5372,73.5 #,55,stable,52.8,39,53777,0,0
MI,"Van Buren County, Michigan",14029,6400,7629,26159,46008,32007,5068,34044,3772,66051,8840,68.2 #,63,stable,58.9,53,75077,0,0
MI,"Washtenaw County, Michigan",51965,25329,26636,26161,61003,160510,11975,167436,9812,327946,21787,54.4 #,172,stable,39.3,123,358880,0,0
MI,"Wayne County, Michigan",440449,200486,239963,26163,41210,726438,121939,823153,95246,1549591,217185,83,1634,falling,57.7,"1,136",1759335,0,1
MI,"Wexford County, Michigan",5631,2846,2785,26165,41534,14036,2235,14703,1532,28739,3767,90.7 #,38,stable,66.9,28,33003,0,0
MN,"Aitkin County, Minnesota",1937,960,977,27001,42252,7304,628,7277,437,14581,1065,_,_,_,40.3,13,15702,0,0
MN,"Anoka County, Minnesota",25925,12012,13913,27003,70873,155823,11886,159251,9448,315074,21334,_,_,_,48.4,145,344151,0,0
MN,"Becker County, Minnesota",4160,1754,2406,27005,52038,14446,1952,14841,1504,29287,3456,_,_,_,46.1,21,33386,0,0
MN,"Beltrami County, Minnesota",8118,3825,4293,27007,44757,19419,3079,19771,2658,39190,5737,_,_,_,41.3,20,45672,0,0
MN,"Benton County, Minnesota",5732,2314,3418,27009,52178,17465,1820,18070,1356,35535,3176,_,_,_,38.8,15,39710,0,0
MN,"Big Stone County, Minnesota",719,260,459,27011,47794,2288,174,2417,126,4705,300,_,_,_,55.9,6,5040,0,0
MN,"Blue Earth County, Minnesota",11745,5827,5918,27013,50061,30414,2115,30581,1479,60995,3594,_,_,_,39.6,25,65787,0,0
MN,"Brown County, Minnesota",1887,931,956,27015,52598,11642,841,11987,579,23629,1420,_,_,_,41.6,16,25313,0,0
MN,"Carlton County, Minnesota",4727,2502,2225,27017,53227,16346,1305,15943,971,32289,2276,_,_,_,48.7,22,35569,0,0
MN,"Carver County, Minnesota",4172,1886,2286,27019,86323,44942,2338,46391,1785,91333,4123,_,_,_,38.8,28,98741,0,0
MN,"Cass County, Minnesota",4656,2195,2461,27021,46531,12836,1582,12842,1039,25678,2621,_,_,_,50.8,24,28706,0,0
MN,"Chippewa County, Minnesota",1454,571,883,27023,50858,5383,518,5591,468,10974,986,_,_,_,29.6,6,12109,0,0
MN,"Chisago County, Minnesota",2889,1389,1500,27025,71001,24809,1884,24450,1341,49259,3225,_,_,_,44.9,24,54293,0,0
MN,"Clay County, Minnesota",7202,3333,3869,27027,57965,27578,2300,29120,1387,56698,3687,_,_,_,42.7,25,62324,0,0
MN,"Clearwater County, Minnesota",1451,704,747,27029,43421,3809,573,3785,488,7594,1061,_,_,_,48.3,6,8803,0,0
MN,"Cottonwood County, Minnesota",1905,862,1043,27033,46750,5179,423,5585,249,10764,672,_,_,_,38.4,7,11549,0,0
MN,"Crow Wing County, Minnesota",7028,3396,3632,27035,49435,28271,2773,29546,1754,57817,4527,_,_,_,50.8,47,63428,0,0
MN,"Dakota County, Minnesota",31270,13735,17535,27037,75567,186300,13285,195459,11601,381759,24886,_,_,_,40.8,148,414686,0,0
MN,"Dodge County, Minnesota",1342,575,767,27039,68116,9491,582,9571,500,19062,1082,_,_,_,40,8,20364,0,0
MN,"Douglas County, Minnesota",3438,1671,1767,27041,54531,16951,1242,17145,892,34096,2134,_,_,_,38.1,21,37075,0,0
MN,"Faribault County, Minnesota",1878,814,1064,27043,47540,6459,557,6437,466,12896,1023,_,_,_,43.1,10,14050,0,0
MN,"Fillmore County, Minnesota",2280,1062,1218,27045,51665,9245,1033,9430,806,18675,1839,_,_,_,30,10,20834,0,0
MN,"Freeborn County, Minnesota",3679,1371,2308,27047,47105,13709,1357,14389,970,28098,2327,_,_,_,39.2,19,30613,0,0
MN,"Goodhue County, Minnesota",5104,2254,2850,27049,57062,20893,1771,21272,1646,42165,3417,_,_,_,41.2,26,46435,0,0
MN,"Grant County, Minnesota",533,209,324,27051,50174,2788,185,2794,134,5582,319,_,_,_,41.4,4,5903,0,0
MN,"Hennepin County, Minnesota",146382,68632,77750,27053,65834,531559,53042,563962,39808,1095521,92850,_,_,_,35.7,411,1223149,0,0
MN,"Houston County, Minnesota",2031,1013,1018,27055,53809,8778,546,8804,468,17582,1014,_,_,_,30.6,9,18773,0,0
MN,"Hubbard County, Minnesota",2368,1092,1276,27057,47486,9250,975,9560,698,18810,1673,_,_,_,46.1,16,20655,0,0
MN,"Isanti County, Minnesota",2802,1404,1398,27059,59865,17605,1560,17777,1036,35382,2596,_,_,_,45,18,38429,0,0
MN,"Itasca County, Minnesota",6018,2849,3169,27061,47761,20410,2134,20142,1898,40552,4032,_,_,_,47.2,32,45435,0,0
MN,"Jackson County, Minnesota",1085,524,561,27063,50574,4773,334,4757,226,9530,560,_,_,_,27,5,10079,0,0
MN,"Kanabec County, Minnesota",2242,1011,1231,27065,47384,7273,765,7292,542,14565,1307,_,_,_,36.9,8,15837,0,0
MN,"Kandiyohi County, Minnesota",4877,2120,2757,27067,52632,19068,1997,19480,1287,38548,3284,_,_,_,40.2,22,42542,0,0
MN,"Koochiching County, Minnesota",1937,956,981,27071,42919,5810,670,5986,427,11796,1097,_,_,_,47,10,12841,0,0
MN,"Lac qui Parle County, Minnesota",561,250,311,27073,49903,3298,203,3252,145,6550,348,_,_,_,37.9,5,6856,0,0
MN,"Lake County, Minnesota",1364,687,677,27075,48417,5051,326,4860,344,9911,670,_,_,_,43.7,8,10631,0,0
MN,"Lake of the Woods County, Minnesota",363,162,201,27077,42263,1792,222,1769,112,3561,334,_,_,_,45.6,3,3923,0,0
MN,"Le Sueur County, Minnesota",2482,1203,1279,27079,60632,13150,806,12839,735,25989,1541,_,_,_,38,13,27663,0,0
MN,"Lincoln County, Minnesota",524,207,317,27081,49575,2669,198,2607,169,5276,367,_,_,_,36.2,4,5771,0,0
MN,"Lyon County, Minnesota",3456,1351,2105,27083,51600,11652,1034,12152,562,23804,1596,_,_,_,37.5,11,25673,0,0
MN,"McLeod County, Minnesota",2866,1279,1587,27085,56128,16345,1426,16902,1057,33247,2483,_,_,_,40.4,18,35932,0,0
MN,"Mahnomen County, Minnesota",1350,638,712,27087,41118,2291,464,2243,460,4534,924,_,_,_,82.7,6,5457,0,0
MN,"Marshall County, Minnesota",734,286,448,27089,54092,4370,405,4280,330,8650,735,_,_,_,53.6,8,9423,0,0
MN,"Martin County, Minnesota",2286,870,1416,27091,51391,9251,725,9456,690,18707,1415,_,_,_,31.1,11,20022,0,0
MN,"Meeker County, Minnesota",2282,951,1331,27093,55042,10443,1102,10532,754,20975,1856,_,_,_,40.7,13,23102,0,0
MN,"Mille Lacs County, Minnesota",3080,1382,1698,27095,49094,11568,1188,11699,896,23267,2084,_,_,_,56.2,19,25788,0,0
MN,"Morrison County, Minnesota",3687,1602,2085,27097,50049,15039,1432,15147,1013,30186,2445,_,_,_,39.6,17,32775,0,0
MN,"Mower County, Minnesota",5410,2667,2743,27099,49427,17518,1895,18117,1318,35635,3213,_,_,_,38.5,22,39116,0,0
MN,"Murray County, Minnesota",771,335,436,27101,51983,3890,299,3905,322,7795,621,_,_,_,33.5,5,8413,0,0
MN,"Nicollet County, Minnesota",3814,1884,1930,27103,58640,15555,844,15863,644,31418,1488,_,_,_,35.5,12,33347,0,0
MN,"Nobles County, Minnesota",3320,1569,1751,27105,50625,9434,1648,9187,1130,18621,2778,_,_,_,26.6,8,21770,0,0
MN,"Norman County, Minnesota",846,383,463,27107,50377,2979,343,3049,195,6028,538,_,_,_,38.6,5,6678,0,0
MN,"Olmsted County, Minnesota",13237,5835,7402,27109,68023,66247,5093,71931,3469,138178,8562,_,_,_,32.3,50,151436,0,0
MN,"Otter Tail County, Minnesota",5635,2449,3186,27111,52365,26409,1967,26916,1504,53325,3471,_,_,_,42,39,57716,0,0
MN,"Pennington County, Minnesota",1286,567,719,27113,47127,6487,499,6681,240,13168,739,_,_,_,34,6,14219,0,0
MN,"Pine County, Minnesota",4015,1890,2125,27115,44549,12590,1473,12495,1049,25085,2522,_,_,_,45.4,18,29069,0,0
MN,"Pipestone County, Minnesota",1182,449,733,27117,46990,3966,479,4408,339,8374,818,_,_,_,46.9,6,9271,0,0
MN,"Polk County, Minnesota",3987,1987,2000,27119,53326,14463,1226,14393,900,28856,2126,_,_,_,44.2,18,31533,0,0
MN,"Pope County, Minnesota",1011,431,580,27121,52785,5121,385,5047,219,10168,604,_,_,_,39.3,7,11041,0,0
MN,"Ramsey County, Minnesota",84589,38727,45862,27123,56104,228045,26230,249216,19701,477261,45931,_,_,_,43,227,538133,0,0
MN,"Red Lake County, Minnesota",431,206,225,27125,50332,1872,184,1914,68,3786,252,_,_,_,54.2,3,4055,0,0
MN,"Redwood County, Minnesota",1825,900,925,27127,47211,7054,757,7071,571,14125,1328,_,_,_,43.7,11,15471,0,0
MN,"Renville County, Minnesota",1646,676,970,27129,52149,7016,563,6798,503,13814,1066,_,_,_,35.4,8,14892,0,0
MN,"Rice County, Minnesota",6469,2720,3749,27131,59598,27682,2731,29574,2022,57256,4753,_,_,_,45,30,65400,0,0
MN,"Rock County, Minnesota",1067,431,636,27133,51496,4210,337,4483,312,8693,649,_,_,_,30.3,5,9600,0,0
MN,"Roseau County, Minnesota",1637,749,888,27135,53199,7498,407,7133,385,14631,792,_,_,_,47.7,9,15770,0,0
MN,"St. Louis County, Minnesota",30869,14248,16621,27137,48331,91466,7407,93151,5140,184617,12547,_,_,_,47,126,200431,0,0
MN,"Scott County, Minnesota",7747,3527,4220,27139,87794,63816,4279,64480,3368,128296,7647,_,_,_,43.8,41,141660,0,0
MN,"Sherburne County, Minnesota",6966,2952,4014,27141,74170,41926,2684,42301,1600,84227,4284,_,_,_,43.2,30,91705,0,0
MN,"Sibley County, Minnesota",1584,699,885,27143,56990,7125,445,6891,431,14016,876,_,_,_,45.6,9,14875,0,0
MN,"Stearns County, Minnesota",19570,9275,10295,27145,56336,70278,5627,71882,3644,142160,9271,_,_,_,35.2,55,154708,0,0
MN,"Steele County, Minnesota",3721,1400,2321,27147,57858,16659,1065,17658,754,34317,1819,_,_,_,33.3,15,36755,0,0
MN,"Swift County, Minnesota",1167,397,770,27151,49035,4446,326,4412,204,8858,530,_,_,_,56.1,8,9340,0,0
MN,"Todd County, Minnesota",3548,1677,1871,27153,46414,10868,1518,10527,1372,21395,2890,_,_,_,38,13,24257,0,0
MN,"Wabasha County, Minnesota",1547,742,805,27157,56510,10047,612,10101,434,20148,1046,_,_,_,48.6,14,21239,0,0
MN,"Wadena County, Minnesota",2211,979,1232,27159,41906,6044,661,6338,424,12382,1085,_,_,_,43.8,10,13875,0,0
MN,"Waseca County, Minnesota",1544,752,792,27161,53564,8524,560,8332,512,16856,1072,_,_,_,48.1,11,18989,0,0
MN,"Washington County, Minnesota",13109,5830,7279,27163,83706,112949,6485,119396,4682,232345,11167,_,_,_,40.2,91,251597,0,0
MN,"Watonwan County, Minnesota",1182,351,831,27165,50604,4631,777,4882,629,9513,1406,_,_,_,46.5,8,10952,0,0
MN,"Winona County, Minnesota",6933,3476,3457,27169,50547,22371,2613,24235,1509,46606,4122,_,_,_,37.8,22,50885,0,0
MN,"Wright County, Minnesota",7846,3355,4491,27171,73557,60440,3886,60402,3171,120842,7057,_,_,_,42.5,44,131311,0,0
MN,"Yellow Medicine County, Minnesota",1175,588,587,27173,53041,4645,462,4459,344,9104,806,_,_,_,42.7,6,9875,0,0
MO,"Adair County, Missouri",6105,2917,3188,29001,37516,10824,1177,11811,1435,22635,2612,57.8,15,stable,43.1,12,25378,0,0
MO,"Andrew County, Missouri",1531,828,703,29003,55613,7657,827,8051,579,15708,1406,50.5,11,stable,37.9,9,17296,0,0
MO,"Atchison County, Missouri",693,298,395,29005,43933,2268,394,2392,287,4660,681,71,7,stable,58.1,6,5306,0,0
MO,"Audrain County, Missouri",4401,2030,2371,29007,41310,9791,1853,10925,1539,20716,3392,90.1,29,stable,63.3,21,26096,0,0
MO,"Barry County, Missouri",7072,3303,3769,29009,39033,14276,3505,14770,2880,29046,6385,77.4,39,rising,60.1,31,35829,1,0
MO,"Barton County, Missouri",2910,1329,1581,29011,37467,5177,780,5425,668,10602,1448,67.2,12,rising,49.1,9,11880,1,0
MO,"Bates County, Missouri",2996,1355,1641,29013,41060,6891,1119,7239,1100,14130,2219,80.8,19,stable,62,15,16446,0,0
MO,"Benton County, Missouri",3540,1492,2048,29015,33042,8015,1303,8169,1163,16184,2466,89.1,33,stable,66.7,24,18670,0,0
MO,"Bollinger County, Missouri",2654,1198,1456,29017,39707,5313,833,5358,766,10671,1599,96.4,16,stable,72.5,12,12182,0,0
MO,"Boone County, Missouri",31824,14224,17600,29019,49899,74337,7488,81131,6446,155468,13934,63.4,86,falling,47.2,63,174974,0,1
MO,"Buchanan County, Missouri",15456,7270,8186,29021,46315,35906,6568,38780,5467,74686,12035,86.8,88,stable,65.1,67,89100,0,0
MO,"Butler County, Missouri",8942,3780,5162,29023,35738,17314,3107,19400,2516,36714,5623,95.7,56,stable,78.3,46,42951,0,0
MO,"Caldwell County, Missouri",1186,487,699,29025,43691,3960,481,4001,453,7961,934,89.3,11,stable,75.2,10,9014,0,0
MO,"Callaway County, Missouri",5865,2577,3288,29027,47744,18353,2151,19311,2318,37664,4469,79.4,39,stable,54.3,26,44834,0,0
MO,"Camden County, Missouri",7516,3496,4020,29029,44816,17731,3647,18484,3655,36215,7302,68.6,51,stable,47.4,35,44237,0,0
MO,"Cape Girardeau County, Missouri",13626,6203,7423,29031,46050,33392,3674,35954,3535,69346,7209,70.1,62,stable,56.6,50,78572,0,0
MO,"Carroll County, Missouri",1273,555,718,29033,42415,3922,437,4094,549,8016,986,94.6,13,stable,63.4,9,8992,0,0
MO,"Carter County, Missouri",1319,613,706,29035,33034,2380,608,2712,551,5092,1159,110,9,stable,92.3,8,6263,0,0
MO,"Cass County, Missouri",9805,3862,5943,29037,61584,43701,5306,46476,4398,90177,9704,70.1,81,stable,53.8,63,101603,0,0
MO,"Cedar County, Missouri",3381,1827,1554,29039,31532,5604,1255,5514,1376,11118,2631,78.3,17,stable,56.7,13,13934,0,0
MO,"Chariton County, Missouri",1213,572,641,29041,40642,3427,307,3430,269,6857,576,67.7,8,stable,50,6,7589,0,0
MO,"Christian County, Missouri",8879,3800,5079,29043,53270,33745,5297,36471,4930,70216,10227,63,53,stable,45.9,37,83279,0,0
MO,"Clark County, Missouri",928,459,469,29045,43883,2926,543,2883,497,5809,1040,95.2,9,stable,67.8,7,6801,0,0
MO,"Clay County, Missouri",20137,9091,11046,29047,62099,99877,12035,105832,11096,205709,23131,79,173,stable,55.7,122,235637,0,0
MO,"Clinton County, Missouri",1856,763,1093,29049,54773,8726,1260,8835,1212,17561,2472,83.5,22,stable,59.3,15,20609,0,0
MO,"Cole County, Missouri",9237,4466,4771,29051,53088,31386,3738,34245,3179,65631,6917,64,53,stable,45.3,37,76720,0,0
MO,"Cooper County, Missouri",2354,1129,1225,29053,44549,6966,1006,7347,725,14313,1731,69,15,stable,51.3,11,17642,0,0
MO,"Crawford County, Missouri",5093,2385,2708,29055,36743,9853,2166,10515,1841,20368,4007,93.1,30,stable,75,24,24526,0,0
MO,"Dade County, Missouri",1473,738,735,29057,37035,3152,649,3070,613,6222,1262,83.3,10,stable,58.4,7,7595,0,0
MO,"Dallas County, Missouri",3577,1685,1892,29059,38062,6336,1862,6412,1760,12748,3622,79.2,18,stable,55.9,13,16393,0,0
MO,"Daviess County, Missouri",1340,567,773,29061,41642,3130,916,3150,881,6280,1797,75,9,stable,58.9,7,8253,0,0
MO,"DeKalb County, Missouri",1391,636,755,29063,41406,4219,527,4212,393,8431,920,39.5,6,stable,38.4,6,12687,0,0
MO,"Dent County, Missouri",3642,1575,2067,29065,36831,6000,1568,6542,1327,12542,2895,74.4,17,stable,62.9,14,15593,0,0
MO,"Douglas County, Missouri",2941,1441,1500,29067,30508,5437,1236,5560,1160,10997,2396,51.9,11,stable,46.7,10,13373,0,0
MO,"Dunklin County, Missouri",8536,3850,4686,29069,31077,12334,2629,13394,2534,25728,5163,100.1,41,stable,81.2,33,30895,0,0
MO,"Franklin County, Missouri",11941,5839,6102,29071,48480,44984,5261,45939,4878,90923,10139,76.9,92,stable,54.4,64,102426,0,0
MO,"Gasconade County, Missouri",2316,1157,1159,29073,42826,6544,770,6742,619,13286,1389,64,15,falling,38,9,14858,0,1
MO,"Gentry County, Missouri",1119,497,622,29075,41912,2818,397,3044,362,5862,759,66.3,7,stable,54.1,6,6692,0,0
MO,"Greene County, Missouri",51533,22824,28709,29077,41227,114052,21695,125498,18123,239550,39818,69.8,220,stable,51.3,162,288072,0,0
MO,"Grundy County, Missouri",2020,900,1120,29079,37656,4033,812,4472,755,8505,1567,71.9,11,stable,55.6,9,10097,0,0
MO,"Harrison County, Missouri",1485,676,809,29081,39301,3585,681,3697,573,7282,1254,79.6,11,stable,55.6,8,8615,0,0
MO,"Henry County, Missouri",4131,1852,2279,29083,42181,9081,1570,9737,1406,18818,2976,100.3,33,stable,83.6,28,21737,0,0
MO,"Hickory County, Missouri",2394,992,1402,29085,32122,3643,917,3872,822,7515,1739,73.4,16,stable,62,13,9201,0,0
MO,"Holt County, Missouri",555,269,286,29087,42500,1970,278,1969,281,3939,559,68.3,5,stable,43.1,3,4484,0,0
MO,"Howard County, Missouri",1587,768,819,29089,44820,4509,504,4607,435,9116,939,54.6,7,rising,39.9,5,10139,1,0
MO,"Howell County, Missouri",9158,4270,4888,29091,32784,16754,2599,18027,2511,34781,5110,81.4,44,stable,65,36,40117,0,0
MO,"Iron County, Missouri",2293,1090,1203,29093,36239,4038,863,4303,775,8341,1638,103.3,16,stable,58.5,9,10125,0,0
MO,"Jackson County, Missouri",119678,53111,66567,29095,46869,274189,51746,301575,46734,575764,98480,75.3,542,stable,55.3,398,687623,0,0
MO,"Jasper County, Missouri",19556,8607,10949,29097,41811,47538,9084,50298,9147,97836,18231,85.8,109,stable,60.7,78,118596,0,0
MO,"Jefferson County, Missouri",23937,11024,12913,29099,55348,97569,11891,100070,10451,197639,22342,85.9,195,stable,71.6,157,224124,0,0
MO,"Johnson County, Missouri",8407,4131,4276,29101,49792,22043,2750,23188,2558,45231,5308,66.1,33,stable,54.1,26,53951,0,0
MO,"Knox County, Missouri",823,384,439,29103,38289,1561,424,1540,433,3101,857,92.7,6,stable,81.5,5,3910,0,0
MO,"Laclede County, Missouri",6816,3199,3617,29105,39712,14481,2881,14812,2946,29293,5827,76.5,35,stable,60.9,27,35473,0,0
MO,"Lafayette County, Missouri",3706,1584,2122,29107,50723,14263,1786,14908,1447,29171,3233,73.9,32,stable,50.1,21,32701,0,0
MO,"Lawrence County, Missouri",7052,3252,3800,29109,40597,15755,2885,16235,2782,31990,5667,66.5,34,stable,53.7,27,38180,0,0
MO,"Lewis County, Missouri",1215,532,683,29111,43909,4568,481,4372,548,8940,1029,79.9,11,rising,68.9,9,10207,1,0
MO,"Lincoln County, Missouri",7980,3595,4385,29113,53718,23642,2898,23748,3079,47390,5977,87.7,45,stable,67.8,35,54696,0,0
MO,"Linn County, Missouri",2196,1008,1188,29115,37997,5065,811,5529,919,10594,1730,91.5,17,stable,65.6,12,12308,0,0
MO,"Livingston County, Missouri",2273,954,1319,29117,43350,5604,965,6401,794,12005,1759,86.8,18,stable,70.4,15,15028,0,0
MO,"McDonald County, Missouri",4876,2218,2658,29119,38368,8953,2573,8596,2482,17549,5055,77.8,19,stable,80.6,19,22643,0,0
MO,"Macon County, Missouri",2895,1311,1584,29121,36976,6564,896,6670,1058,13234,1954,41.9,10,rising,40.9,10,15335,1,0
MO,"Madison County, Missouri",2238,888,1350,29123,35097,4999,953,5528,752,10527,1705,106.8,19,stable,98.5,17,12408,0,0
MO,"Maries County, Missouri",1721,883,838,29125,39700,3874,585,3844,630,7718,1215,60.4,8,stable,72.6,9,8963,0,0
MO,"Marion County, Missouri",5020,2181,2839,29127,40814,11569,1990,12609,1996,24178,3986,87.9,33,stable,58.6,22,28880,0,0
MO,"Mercer County, Missouri",584,269,315,29129,40768,1438,395,1507,322,2945,717,114.1,7,stable,74.2,4,3694,0,0
MO,"Miller County, Missouri",4942,2218,2724,29131,38094,10355,1786,10929,1608,21284,3394,88.8,28,stable,68.4,22,25113,0,0
MO,"Mississippi County, Missouri",3642,1370,2272,29133,28347,4754,1288,5250,1214,10004,2502,100,18,stable,97.2,17,14036,0,0
MO,"Moniteau County, Missouri",1885,896,989,29135,47725,5859,1191,6205,1222,12064,2413,54.6,10,stable,46.6,8,15963,0,0
MO,"Monroe County, Missouri",1260,621,639,29137,43138,3677,648,3682,566,7359,1214,77.2,10,stable,44.1,6,8583,0,0
MO,"Montgomery County, Missouri",2025,923,1102,29139,39830,4996,786,5140,676,10136,1462,83,14,stable,50.7,9,11703,0,0
MO,"Morgan County, Missouri",4757,2515,2242,29141,33525,7732,2303,7555,2318,15287,4621,85,29,stable,65.6,23,20171,0,0
MO,"New Madrid County, Missouri",4094,1799,2295,29143,33630,7092,1596,7626,1728,14718,3324,112.7,28,stable,84.5,21,18208,0,0
MO,"Newton County, Missouri",8377,3814,4563,29145,43290,24386,4432,24757,4545,49143,8977,57.8,42,stable,55.5,40,58615,0,0
MO,"Nodaway County, Missouri",5682,2463,3219,29147,35854,9723,1143,10229,1189,19952,2332,73.5,18,stable,48.7,12,22810,0,0
MO,"Oregon County, Missouri",2824,1355,1469,29149,29851,4449,885,4581,930,9030,1815,65.2,12,stable,40.7,7,10953,0,0
MO,"Osage County, Missouri",1139,603,536,29151,52693,6519,641,6123,336,12642,977,59.6,10,stable,41.5,7,13628,0,0
MO,"Ozark County, Missouri",2292,1023,1269,29153,31399,3965,858,3938,719,7903,1577,78.9,14,stable,61.6,11,9409,0,0
MO,"Pemiscot County, Missouri",5068,2070,2998,29155,29238,6879,1462,7736,1580,14615,3042,88.6,19,stable,90.5,19,17482,0,0
MO,"Perry County, Missouri",1798,765,1033,29157,51499,8633,751,8765,658,17398,1409,75.1,18,stable,53.2,13,19183,0,0
MO,"Pettis County, Missouri",7484,3292,4192,29159,39928,16923,3233,18256,3036,35179,6269,71.2,35,stable,55.3,27,42255,0,0
MO,"Phelps County, Missouri",8137,4289,3848,29161,41618,20113,2833,18995,2189,39108,5022,71.7,36,stable,51.7,26,44794,0,0
MO,"Pike County, Missouri",2482,1017,1465,29163,41750,6882,1238,7243,908,14125,2146,94.3,22,stable,57,13,18348,0,0
MO,"Platte County, Missouri",7106,2824,4282,29165,68254,41729,3706,43224,3804,84953,7510,59.8,56,stable,44.2,40,96096,0,0
MO,"Polk County, Missouri",5515,2420,3095,29167,41130,13045,1922,13745,1993,26790,3915,66,26,stable,54,21,31229,0,0
MO,"Pulaski County, Missouri",5781,2598,3183,29169,47931,16880,2934,17970,2288,34850,5222,103.4,35,stable,67.9,23,53221,0,0
MO,"Putnam County, Missouri",926,444,482,29171,36346,2057,382,2040,363,4097,745,92.9,7,stable,63.3,5,4858,0,0
MO,"Ralls County, Missouri",1254,511,743,29173,47345,4421,700,4473,595,8894,1295,67,9,stable,65.7,9,10196,0,0
MO,"Randolph County, Missouri",4395,1944,2451,29175,37832,9737,1641,10388,1432,20125,3073,84.8,25,stable,62.8,18,25104,0,0
MO,"Ray County, Missouri",3598,1755,1843,29177,52526,10234,1135,10395,986,20629,2121,92.8,27,stable,77.3,22,22810,0,0
MO,"Reynolds County, Missouri",1361,658,703,29179,35648,2900,383,2725,436,5625,819,68.4,7,stable,59.6,6,6432,0,0
MO,"Ripley County, Missouri",3167,1376,1791,29181,32444,5641,1250,5926,1100,11567,2350,95,20,stable,82,17,13802,0,0
MO,"St. Charles County, Missouri",23022,10046,12976,29183,72415,170019,13371,177309,12345,347328,25716,73.7,264,stable,50,176,385590,0,0
MO,"St. Clair County, Missouri",2156,1042,1114,29185,32046,3806,881,3809,792,7615,1673,73.6,13,falling,66.6,12,9440,0,1
MO,"Ste. Genevieve County, Missouri",2540,925,1615,29186,47014,8552,418,8046,767,16598,1185,53.6,13,stable,62.5,15,17919,0,0
MO,"St. Francois County, Missouri",11138,4933,6205,29187,39741,24374,4136,26292,3638,50666,7774,106.8,82,stable,76.7,59,66520,0,0
MO,"St. Louis County, Missouri",106821,44437,62384,29189,59755,423435,45306,477858,42847,901293,88153,69,854,stable,45.9,574,1003362,0,0
MO,"Saline County, Missouri",3808,1786,2022,29195,40101,10359,1083,10451,987,20810,2070,74.3,22,stable,52.1,16,23258,0,0
MO,"Schuyler County, Missouri",914,407,507,29197,37500,1662,454,1855,372,3517,826,64.2,4,stable,70,4,4436,0,0
MO,"Scotland County, Missouri",730,279,451,29199,39772,1613,778,1806,581,3419,1359,58,4,stable,53.8,4,4854,0,0
MO,"Scott County, Missouri",7492,3283,4209,29201,39162,16351,2471,17253,2522,33604,4993,99,49,stable,73.8,36,39008,0,0
MO,"Shannon County, Missouri",1938,808,1130,29203,32404,3358,716,3501,678,6859,1394,70.3,9,stable,57.8,7,8258,0,0
MO,"Shelby County, Missouri",1092,466,626,29205,39087,2474,497,2554,447,5028,944,71.9,7,stable,39.6,3,6128,0,0
MO,"Stoddard County, Missouri",4583,1898,2685,29207,38203,12035,2363,12921,2117,24956,4480,93.4,39,stable,71.2,30,29862,0,0
MO,"Stone County, Missouri",5147,2154,2993,29209,40510,12806,2449,13343,2523,26149,4972,66.5,39,stable,50,28,30943,0,0
MO,"Sullivan County, Missouri",1066,407,659,29211,40197,2783,488,2689,495,5472,983,88.6,8,stable,54.6,5,6353,0,0
MO,"Taney County, Missouri",9825,4609,5216,29213,38357,20078,5674,21802,5549,41880,11223,80.6,58,stable,52.4,38,54592,0,0
MO,"Texas County, Missouri",5214,2506,2708,29215,35088,9999,1996,10373,1902,20372,3898,71,26,stable,56.1,21,25690,0,0
MO,"Vernon County, Missouri",3764,1645,2119,29217,40693,7993,1875,8945,1590,16938,3465,75.9,21,rising,61.9,17,20826,1,0
MO,"Warren County, Missouri",4507,2131,2376,29219,51133,14369,2102,14662,1732,29031,3834,76,30,stable,56.9,22,33513,0,0
MO,"Washington County, Missouri",5030,2223,2807,29221,35305,10110,1857,10145,1849,20255,3706,93,28,stable,81.1,24,24788,0,0
MO,"Wayne County, Missouri",2960,1342,1618,29223,33750,5477,1115,5609,1054,11086,2169,114.9,25,stable,87.9,19,13405,0,0
MO,"Webster County, Missouri",6733,3198,3535,29225,44451,14141,3790,14511,3378,28652,7168,73.9,30,stable,49,19,37483,0,0
MO,"Wright County, Missouri",4594,2173,2421,29229,29778,7116,1859,7620,1657,14736,3516,83.4,21,falling,69.4,18,18268,0,1
MO,"St. Louis city, Missouri",83416,37160,46256,29510,35599,122966,27480,138200,24440,261166,51920,88.9,275,stable,66.2,204,315685,0,0
MS,"Adams County, Mississippi",8898,3858,5040,28001,28869,10865,3146,13122,2483,23987,5629,69,29,stable,60.6,26,31254,0,0
MS,"Alcorn County, Mississippi",7752,3445,4307,28003,36163,14442,3433,16119,2794,30561,6227,75.7,37,stable,59.9,29,37388,0,0
MS,"Amite County, Mississippi",2852,1314,1538,28005,30704,5265,1026,5465,971,10730,1997,56.9,11,stable,51.1,10,12574,0,0
MS,"Attala County, Mississippi",4908,1796,3112,28007,32886,7498,1341,8869,1160,16367,2501,62.5,17,stable,57.3,15,19043,0,0
MS,"Benton County, Mississippi",1764,886,878,28009,33141,3398,676,3619,696,7017,1372,61.8,7,stable,46.1,5,8182,0,0
MS,"Bolivar County, Mississippi",11900,5142,6758,28011,27585,11911,3314,15085,2666,26996,5980,76.2,27,stable,66.2,23,33322,0,0
MS,"Calhoun County, Mississippi",3763,1682,2081,28013,31098,5841,1212,6498,1086,12339,2298,88.1,17,stable,75.9,15,14717,0,0
MS,"Carroll County, Mississippi",2086,839,1247,28015,37289,4276,770,4524,580,8800,1350,72.3,11,stable,60.1,9,10243,0,0
MS,"Chickasaw County, Mississippi",4493,1854,2639,28017,30926,6650,1511,7634,1291,14284,2802,78.4,16,falling,63.7,13,17328,0,1
MS,"Choctaw County, Mississippi",2147,862,1285,28019,30692,3352,659,3784,459,7136,1118,44.4,5,stable,42.1,5,8299,0,0
MS,"Claiborne County, Mississippi",3685,1830,1855,28021,23259,3398,910,4110,858,7508,1768,93.3,10,stable,53.9,6,9150,0,0
MS,"Clarke County, Mississippi",3460,1429,2031,28023,35993,6669,1016,7430,1191,14099,2207,75,17,stable,67.3,15,16006,0,0
MS,"Clay County, Mississippi",5302,2240,3062,28025,31669,7804,1453,9273,1464,17077,2917,78.5,20,stable,60.8,15,20048,0,0
MS,"Coahoma County, Mississippi",8420,3418,5002,28027,28851,9445,2065,11366,2085,20811,4150,76.3,21,stable,61.8,17,24620,0,0
MS,"Copiah County, Mississippi",7629,3440,4189,28029,35130,10959,2943,12458,2411,23417,5354,86.2,30,stable,59.5,20,28773,0,0
MS,"Covington County, Mississippi",5162,2139,3023,28031,31631,7549,1596,8578,1499,16127,3095,78,19,stable,44.8,11,19543,0,0
MS,"DeSoto County, Mississippi",16338,6777,9561,28033,58278,70131,11179,75876,10577,146007,21756,78.4,118,stable,58.5,85,173323,0,0
MS,"Forrest County, Mississippi",20179,9239,10940,28035,36416,28939,6894,33998,5750,62937,12644,84.2,61,stable,63.6,46,75944,0,0
MS,"Franklin County, Mississippi",1464,703,761,28037,38170,3170,621,3314,672,6484,1293,49.9,5,stable,35.2,4,7743,0,0
MS,"George County, Mississippi",4154,1784,2370,28039,44258,9247,1973,9214,2200,18461,4173,74.7,19,stable,76.9,18,23373,0,0
MS,"Greene County, Mississippi",1566,553,1013,28041,40176,4221,945,4659,995,8880,1940,46.1,7,stable,45.9,7,13522,0,0
MS,"Grenada County, Mississippi",4733,2254,2479,28043,31779,8671,1336,9911,1348,18582,2684,93.4,25,stable,74.2,20,21578,0,0
MS,"Hancock County, Mississippi",9807,4704,5103,28045,43355,17172,5111,18887,4307,36059,9418,72.8,41,stable,49.8,28,46420,0,0
MS,"Harrison County, Mississippi",39569,17498,22071,28047,41722,72667,18692,79448,17720,152115,36412,89.5,179,stable,67.5,132,201410,0,0
MS,"Hinds County, Mississippi",61498,26487,35011,28049,37324,92795,20840,110849,18840,203644,39680,75.4,178,stable,46.4,110,242891,0,0
MS,"Holmes County, Mississippi",7860,3472,4388,28051,20732,7016,1885,8096,1636,15112,3521,95,19,stable,62.2,13,18340,0,0
MS,"Humphreys County, Mississippi",3508,1539,1969,28053,23216,3399,831,3738,929,7137,1760,72.3,7,stable,54.9,5,8669,0,0
MS,"Itawamba County, Mississippi",4207,2133,2074,28057,35004,9983,1592,10393,1248,20376,2840,95.6,28,stable,68.9,20,23609,0,0
MS,"Jackson County, Mississippi",21400,9488,11912,28059,48406,56066,12275,59214,11759,115280,24034,75.8,116,falling,61.3,92,141425,0,1
MS,"Jasper County, Mississippi",3944,1645,2299,28061,31578,6799,1160,7498,1015,14297,2175,78.7,18,stable,52,12,16569,0,0
MS,"Jefferson County, Mississippi",3490,1504,1986,28063,20743,2776,509,3353,521,6129,1030,77.7,7,stable,59.7,5,7507,0,0
MS,"Jefferson Davis County, Mississippi",4028,1624,2404,28065,26279,4525,1117,4954,1234,9479,2351,68.6,12,stable,55,9,11665,0,0
MS,"Jones County, Mississippi",15197,6073,9124,28067,37143,28118,4544,29379,5481,57497,10025,62.9,50,stable,56,45,68215,0,0
MS,"Kemper County, Mississippi",2841,1127,1714,28069,30056,3883,763,4280,741,8163,1504,57,8,stable,48.3,7,9969,0,0
MS,"Lafayette County, Mississippi",11903,5486,6417,28071,44643,21278,3156,23650,2499,44928,5655,63.6,28,stable,50.6,21,53154,0,0
MS,"Lamar County, Mississippi",9748,4503,5245,28073,52035,23481,4500,25482,4475,48963,8975,62.7,33,stable,41.7,21,60618,0,0
MS,"Lauderdale County, Mississippi",17325,6745,10580,28075,38132,30735,5094,34787,5848,65522,10942,70.4,65,stable,53,49,78524,0,0
MS,"Lawrence County, Mississippi",2769,1275,1494,28077,35634,5157,1011,5309,1096,10466,2107,106,17,stable,76,12,12622,0,0
MS,"Leake County, Mississippi",6034,2548,3486,28079,33452,8559,2216,9134,2293,17693,4509,75,20,stable,73.6,19,22763,0,0
MS,"Lee County, Mississippi",15327,6413,8914,28081,42784,34316,5627,38624,5447,72940,11074,91.3,83,stable,84.5,77,85300,0,0
MS,"Leflore County, Mississippi",12558,5473,7085,28083,24233,11343,3248,13590,2675,24933,5923,82.3,26,stable,67.7,22,30999,0,0
MS,"Lincoln County, Mississippi",9091,3751,5340,28085,36473,13904,2489,14956,2823,28860,5312,68.5,28,stable,51.8,21,34649,0,0
MS,"Lowndes County, Mississippi",13675,5540,8135,28087,40239,22830,4314,25998,4761,48828,9075,70.2,45,stable,56.4,37,59710,0,0
MS,"Madison County, Mississippi",13287,5430,7857,28089,64376,42518,4619,47943,3948,90461,8567,70.9,64,stable,87.4,78,103465,0,0
MS,"Marion County, Mississippi",7156,3313,3843,28091,30668,10094,2173,10761,2325,20855,4498,81.8,27,falling,63.7,21,25563,0,1
MS,"Marshall County, Mississippi",6513,2947,3566,28093,37419,13625,3139,15270,3070,28895,6209,80.6,34,stable,70.1,29,35916,0,0
MS,"Monroe County, Mississippi",7123,2940,4183,28095,36783,14672,2389,16099,2600,30771,4989,81.6,38,stable,57.1,26,35827,0,0
MS,"Montgomery County, Mississippi",3058,1215,1843,28097,30146,4323,547,4879,598,9202,1145,65.6,10,stable,57,8,10152,0,0
MS,"Neshoba County, Mississippi",6957,3071,3886,28099,35645,11396,2592,12623,2524,24019,5116,59.2,19,stable,58.3,19,29463,0,0
MS,"Newton County, Mississippi",4737,1955,2782,28101,37045,8499,1583,9843,1548,18342,3131,68.2,18,stable,54.5,14,21747,0,0
MS,"Noxubee County, Mississippi",3953,1771,2182,28103,26677,4081,1140,4761,964,8842,2104,57.8,8,stable,52.2,7,11043,0,0
MS,"Oktibbeha County, Mississippi",14780,7021,7759,28105,32485,21214,3109,21499,2799,42713,5908,51.9,20,stable,42.9,16,49800,0,0
MS,"Panola County, Mississippi",7793,3400,4393,28107,36555,13551,2876,15501,2246,29052,5122,75.2,29,stable,73.8,28,34167,0,0
MS,"Pearl River County, Mississippi",11590,4999,6591,28109,40976,21467,5306,22456,5103,43923,10409,89,60,stable,70,47,55191,0,0
MS,"Perry County, Mississippi",2287,865,1422,28111,34045,4383,1495,5138,1067,9521,2562,81.6,12,stable,58.6,8,12277,0,0
MS,"Pike County, Mississippi",11334,4633,6701,28113,31677,15503,3132,17909,2925,33412,6057,78.4,38,stable,63.1,30,39956,0,0
MS,"Pontotoc County, Mississippi",4903,2537,2366,28115,40645,11979,3300,12552,2433,24531,5733,80.5,27,stable,60.4,20,30908,0,0
MS,"Prentiss County, Mississippi",5112,2431,2681,28117,32945,10214,2063,11030,1784,21244,3847,82.4,26,stable,78.2,24,25459,0,0
MS,"Quitman County, Mississippi",2982,1280,1702,28119,24583,2771,848,3192,776,5963,1624,75.1,7,stable,66.1,6,7486,0,0
MS,"Rankin County, Mississippi",14067,5528,8539,28121,58801,58718,8313,66576,7485,125294,15798,76.4,111,stable,46.9,67,149039,0,0
MS,"Scott County, Mississippi",7743,3362,4381,28123,32935,10538,2999,11649,2843,22187,5842,87.3,27,stable,64.3,19,28265,0,0
MS,"Sharkey County, Mississippi",1380,607,773,28125,30525,1542,565,2224,376,3766,941,55.8,3,stable,62.4,4,4585,0,0
MS,"Simpson County, Mississippi",6985,3372,3613,28127,35375,10553,2396,11369,2450,21922,4846,85.9,28,stable,60.5,20,27222,0,0
MS,"Smith County, Mississippi",3813,1606,2207,28129,32951,6684,1116,7253,1117,13937,2233,61.9,13,stable,65.8,14,16059,0,0
MS,"Stone County, Mississippi",3103,1626,1477,28131,45025,7048,1645,7318,1406,14366,3051,82.2,16,falling,71.8,13,18070,0,1
MS,"Sunflower County, Mississippi",8458,3444,5014,28133,27384,8412,2549,10925,2264,19337,4813,65,18,stable,59.8,17,27005,0,0
MS,"Tallahatchie County, Mississippi",2609,881,1728,28135,29731,3552,962,5273,726,8825,1688,81.1,13,stable,67.1,11,14588,0,0
MS,"Tate County, Mississippi",4656,2196,2460,28137,42880,11062,2487,12572,1817,23634,4304,87.8,27,stable,69.3,22,28296,0,0
MS,"Tippah County, Mississippi",5311,2352,2959,28139,35609,9246,1568,9666,1471,18912,3039,71.8,19,stable,52.8,14,22131,0,0
MS,"Tishomingo County, Mississippi",3146,1342,1804,28141,35143,7612,1654,8535,1478,16147,3132,78.4,22,stable,56.2,16,19552,0,0
MS,"Tunica County, Mississippi",2824,999,1825,28143,31211,3816,1036,4686,817,8502,1853,84.2,8,stable,56.6,5,10343,0,0
MS,"Union County, Mississippi",6170,2262,3908,28145,35865,10912,2427,11947,2257,22859,4684,72.4,23,stable,51.6,17,28429,0,0
MS,"Walthall County, Mississippi",4199,1956,2243,28147,31384,6014,1282,5852,1690,11866,2972,50.8,10,stable,57.4,11,14638,0,0
MS,"Warren County, Mississippi",10768,4265,6503,28149,41121,18641,3958,21323,3671,39964,7629,73.7,41,stable,56.8,31,47485,0,0
MS,"Washington County, Mississippi",17586,7493,10093,28151,29144,18157,4827,20778,5284,38935,10111,75.8,42,rising,63,34,48130,1,0
MS,"Wayne County, Mississippi",5509,2334,3175,28153,32557,8352,1605,8995,1494,17347,3099,61.2,15,stable,55.6,14,20566,0,0
MS,"Webster County, Mississippi",2243,977,1266,28155,34448,3951,922,4467,573,8418,1495,90.6,12,stable,76.6,10,9899,0,0
MS,"Wilkinson County, Mississippi",2687,1182,1505,28157,29931,3268,709,3551,812,6819,1521,60.5,7,stable,46.7,5,9122,0,0
MS,"Winston County, Mississippi",5389,2222,3167,28159,33202,7620,1061,8191,1373,15811,2434,83.9,21,stable,58.1,15,18317,0,0
MS,"Yalobusha County, Mississippi",2472,1069,1403,28161,36502,5011,965,5613,608,10624,1573,114.7,20,stable,78.4,14,12447,0,0
MS,"Yazoo County, Mississippi",8017,3652,4365,28163,28961,9419,2631,10493,1724,19912,4355,95.3,27,stable,59.6,17,27387,0,0
MT,"Beaverhead County, Montana",1446,604,842,30001,41512,4070,562,4035,490,8105,1052,52,7,stable,28.3,4,9300,0,0
MT,"Carbon County, Montana",1137,505,632,30009,49767,4396,704,4453,647,8849,1351,35.8,6,stable,21.3,4,10408,0,0
MT,"Cascade County, Montana",12212,5336,6876,30013,45205,32558,5433,35087,5132,67645,10565,66.6,68,stable,50.3,51,82278,0,0
MT,"Custer County, Montana",1298,566,732,30017,48750,5149,672,5260,625,10409,1297,70.8,11,stable,48.9,9,12135,0,0
MT,"Dawson County, Montana",1210,741,469,30021,52738,4065,605,3919,437,7984,1042,84.6,11,stable,49.4,6,9625,0,0
MT,"Deer Lodge County, Montana",1499,739,760,30023,39399,3834,745,3656,487,7490,1232,59.5,9,stable,53.1,8,9139,0,0
MT,"Fergus County, Montana",1287,592,695,30027,40881,4763,888,4876,721,9639,1609,58.5,12,stable,50.5,10,11427,0,0
MT,"Flathead County, Montana",12307,5818,6489,30029,47851,38210,8056,39283,7180,77493,15236,58.4,65,stable,33.4,38,96165,0,0
MT,"Gallatin County, Montana",12125,6297,5828,30031,55553,42674,6272,41109,4917,83783,11189,37.1,29,falling,27.8,21,100739,0,1
MT,"Glacier County, Montana",4447,1962,2485,30035,29640,4047,2542,4625,2325,8672,4867,92.4,11,stable,62.5,7,13647,0,0
MT,"Hill County, Montana",3400,1581,1819,30041,44633,7002,1317,6551,1519,13553,2836,64.4,11,stable,33.2,6,16572,0,0
MT,"Jefferson County, Montana",1068,531,537,30043,60842,5373,511,4850,599,10223,1110,71.9,11,stable,50.1,7,11645,0,0
MT,"Lake County, Montana",6509,3171,3338,30047,38732,10614,3612,11416,3344,22030,6956,52.6,21,stable,37.4,15,29457,0,0
MT,"Lewis and Clark County, Montana",7803,3651,4152,30049,56197,28620,3455,29722,2920,58342,6375,65.2,49,stable,45.4,34,66418,0,0
MT,"Lincoln County, Montana",3554,1627,1927,30053,35275,7780,1879,7663,1845,15443,3724,71.4,24,stable,56.8,18,19052,0,0
MT,"Madison County, Montana",820,408,412,30057,46250,3376,685,3131,515,6507,1200,44.9,6,stable,31.3,4,7915,0,0
MT,"Mineral County, Montana",721,331,390,30061,36031,1591,509,1767,319,3358,828,66.4,5,stable,56.9,4,4251,0,0
MT,"Missoula County, Montana",17414,8279,9135,30063,46164,46957,8965,48368,7019,95325,15984,56.9,61,stable,42,45,114181,0,0
MT,"Musselshell County, Montana",774,324,450,30065,39517,2075,297,2021,363,4096,660,82,6,stable,66.6,5,4582,0,0
MT,"Park County, Montana",1918,828,1090,30067,43932,6335,1508,6846,929,13181,2437,42.8,9,stable,22.8,5,15972,0,0
MT,"Phillips County, Montana",651,274,377,30071,36071,1612,466,1678,371,3290,837,53.2,4,stable,54.2,4,4169,0,0
MT,"Pondera County, Montana",1283,676,607,30073,42264,2449,589,2625,471,5074,1060,66.3,6,stable,40.4,3,6184,0,0
MT,"Powell County, Montana",735,319,416,30077,40000,2370,414,2215,372,4585,786,85.3,8,stable,44,4,6840,0,0
MT,"Ravalli County, Montana",7308,3338,3970,30081,39480,16273,3831,17080,3386,33353,7217,48.9,31,stable,33,21,41373,0,0
MT,"Richland County, Montana",1264,547,717,30083,65084,4632,1067,4405,1028,9037,2095,78.6,10,stable,43.1,5,11960,0,0
MT,"Roosevelt County, Montana",3007,1383,1624,30085,32974,3768,1672,4041,1373,7809,3045,64.2,6,stable,33.7,3,11476,0,0
MT,"Rosebud County, Montana",1893,826,1067,30087,51159,3493,1025,3560,1191,7053,2216,56.8,5,stable,39.5,3,9398,0,0
MT,"Sanders County, Montana",2497,1104,1393,30089,32257,4653,1092,4124,1341,8777,2433,62.1,13,stable,45.4,9,11336,0,0
MT,"Sheridan County, Montana",373,165,208,30091,50664,1621,193,1650,112,3271,305,68,5,stable,59.7,4,3687,0,0
MT,"Silver Bow County, Montana",6771,3228,3543,30093,37749,14473,2808,14162,2516,28635,5324,56,25,stable,44,20,34622,0,0
MT,"Stillwater County, Montana",721,312,409,30095,58259,4172,507,4038,512,8210,1019,49.2,7,stable,29.7,4,9486,0,0
MT,"Sweet Grass County, Montana",458,203,255,30097,50588,1534,226,1665,177,3199,403,70.2,4,stable,59.3,4,3634,0,0
MT,"Teton County, Montana",723,348,375,30099,46360,2544,442,2580,439,5124,881,60.8,6,stable,55.7,5,6104,0,0
MT,"Toole County, Montana",866,341,525,30101,44804,1838,518,1732,454,3570,972,77.5,5,stable,48.7,3,5087,0,0
MT,"Yellowstone County, Montana",17250,7477,9773,30111,52802,63566,10886,66659,10258,130225,21144,60.9,105,stable,45,79,157048,0,0
NC,"Alamance County, North Carolina",29042,13130,15912,37001,41814,61793,11848,68721,11831,130514,23679,71.3,131,stable,51.8,95,158276,0,0
NC,"Alexander County, North Carolina",6191,3003,3188,37003,39365,15713,2301,16031,1981,31744,4282,75.7,36,stable,51.1,24,37325,0,0
NC,"Alleghany County, North Carolina",1986,852,1134,37005,36968,4369,1002,4481,931,8850,1933,62.4,12,stable,59.3,11,10837,0,0
NC,"Anson County, North Carolina",5865,2550,3315,37007,33228,9707,2339,10387,1918,20094,4257,80.5,26,stable,56.3,18,25759,0,0
NC,"Ashe County, North Carolina",5510,2737,2773,37009,36267,10685,2605,11580,1983,22265,4588,70.1,30,stable,52.1,22,27020,0,0
NC,"Avery County, North Carolina",2350,1240,1110,37011,37777,6224,1573,6565,1376,12789,2949,65.5,17,stable,49,13,17689,0,0
NC,"Beaufort County, North Carolina",8660,3746,4914,37013,40391,19022,3482,21646,3048,40668,6530,83.5,58,stable,59.1,41,47651,0,0
NC,"Bertie County, North Carolina",4304,2038,2266,37015,30027,7722,1578,8666,1315,16388,2893,69.7,20,stable,49.4,14,20199,0,0
NC,"Bladen County, North Carolina",9342,4175,5167,37017,30096,13489,2722,15516,2571,29005,5293,64.1,30,stable,51.1,25,34318,0,0
NC,"Brunswick County, North Carolina",18725,8143,10582,37019,46859,46541,9270,51200,7963,97741,17233,69.8,127,stable,56.8,101,122765,0,0
NC,"Buncombe County, North Carolina",38256,17640,20616,37021,45167,97521,19497,109819,16677,207340,36174,66.2,211,stable,47,150,253178,0,0
NC,"Burke County, North Carolina",17277,7762,9515,37023,39360,35628,7025,38742,5727,74370,12752,83.1,100,stable,61,73,88842,0,0
NC,"Cabarrus County, North Carolina",23384,10512,12872,37025,54720,78787,12302,84177,11749,162964,24051,76.9,135,stable,53.1,92,196762,0,0
NC,"Caldwell County, North Carolina",15765,6956,8809,37027,35763,32631,6954,35162,6149,67793,13103,82.9,89,falling,69.1,73,81287,0,1
NC,"Camden County, North Carolina",803,370,433,37029,58780,4459,488,4608,432,9067,920,41.1,5,stable,25.4,3,10309,0,0
NC,"Carteret County, North Carolina",10056,4547,5509,37031,48457,26963,5127,29397,4961,56360,10088,76.1,77,stable,62.9,63,68879,0,0
NC,"Caswell County, North Carolina",4634,2029,2605,37033,37869,9255,1611,9896,1485,19151,3096,70.4,22,rising,50.2,16,22941,1,0
NC,"Catawba County, North Carolina",23629,10699,12930,37035,44376,63444,11588,68560,9556,132004,21144,68.8,126,stable,54,99,155056,0,0
NC,"Chatham County, North Carolina",9041,4550,4491,37037,56642,27262,5354,30028,4042,57290,9396,53,52,stable,38.5,39,70928,0,0
NC,"Cherokee County, North Carolina",5319,2403,2916,37039,34662,10488,2637,11249,2436,21737,5073,79.1,39,stable,57.2,28,27178,0,0
NC,"Chowan County, North Carolina",3832,1747,2085,37041,38759,5740,1163,6529,956,12269,2119,66.1,15,stable,59.2,14,14394,0,0
NC,"Clay County, North Carolina",2235,1007,1228,37043,37076,4078,994,4521,1002,8599,1996,69.3,14,stable,50.3,10,10703,0,0
NC,"Cleveland County, North Carolina",19156,8012,11144,37045,39453,38871,7516,43812,6666,82683,14182,72.3,90,stable,59.2,73,96879,0,0
NC,"Columbus County, North Carolina",12768,5572,7196,37047,34949,20690,5109,24204,4529,44894,9638,82.6,61,stable,63.6,46,56694,0,0
NC,"Craven County, North Carolina",15664,6578,9086,37049,47985,38039,7825,44473,6620,82512,14445,81,103,stable,57,73,103451,0,0
NC,"Cumberland County, North Carolina",54949,22453,32496,37051,44171,115293,19292,143351,18868,258644,38160,73.3,202,stable,56.6,154,323838,0,0
NC,"Currituck County, North Carolina",2497,1018,1479,37053,60600,9858,2142,10360,1831,20218,3973,78.6,22,falling,70.8,18,25263,0,1
NC,"Dare County, North Carolina",2885,1204,1681,37055,54496,13604,3436,14946,2720,28550,6156,66.3,31,stable,41.8,18,35663,0,0
NC,"Davidson County, North Carolina",25655,11254,14401,37057,43363,67953,11300,72487,10369,140440,21669,83.9,170,stable,61.3,122,164622,0,0
NC,"Davie County, North Carolina",5210,2384,2826,37059,51527,17033,2985,18774,2265,35807,5250,81.6,47,stable,48.3,27,41753,0,0
NC,"Duplin County, North Carolina",15606,7197,8409,37061,35035,21885,6997,24085,5858,45970,12855,62,45,stable,48,34,59159,0,0
NC,"Durham County, North Carolina",49835,23570,26265,37063,52503,110556,23537,130140,19125,240696,42662,61.1,147,stable,46.6,110,300952,0,0
NC,"Edgecombe County, North Carolina",14210,6021,8189,37065,32659,20437,4951,24507,4335,44944,9286,65.8,47,stable,53.5,38,54150,0,0
NC,"Forsyth County, North Carolina",69100,30558,38542,37067,45471,142855,27087,164825,23837,307680,50924,70.9,277,stable,52.9,206,369019,0,0
NC,"Franklin County, North Carolina",9603,4247,5356,37069,42685,25114,5007,26451,4666,51565,9673,76.3,53,stable,58.9,40,63710,0,0
NC,"Gaston County, North Carolina",36027,15570,20457,37071,42429,83675,16824,91558,15628,175233,32452,87.2,211,stable,63.1,150,213442,0,0
NC,"Gates County, North Carolina",1651,683,968,37073,49258,5023,707,5360,536,10383,1243,51.8,8,stable,56,9,11431,0,0
NC,"Graham County, North Carolina",1884,867,1017,37075,34805,3237,970,3518,861,6755,1831,48.8,7,stable,35.3,5,8616,0,0
NC,"Granville County, North Carolina",8943,4172,4771,37077,50225,22929,3950,25312,2850,48241,6800,82.3,56,stable,52.5,35,58674,0,0
NC,"Greene County, North Carolina",4962,2049,2913,37079,35777,7809,1790,8255,1427,16064,3217,70.2,17,stable,56.9,13,21134,0,0
NC,"Guilford County, North Carolina",86808,37328,49480,37081,45651,200451,37996,230196,34220,430647,72216,70.3,367,stable,48.3,251,517600,0,0
NC,"Halifax County, North Carolina",13660,6086,7574,37083,32245,20409,4057,24473,3054,44882,7111,68.9,51,stable,52.4,39,52456,0,0
NC,"Harnett County, North Carolina",22094,9986,12108,37085,46353,47081,8855,53827,8332,100908,17187,86.3,93,stable,60.2,63,128140,0,0
NC,"Haywood County, North Carolina",10056,4642,5414,37087,42257,23777,4670,26178,4045,49955,8715,70.2,67,stable,47.7,46,59868,0,0
NC,"Henderson County, North Carolina",14984,7217,7767,37089,46448,43911,8840,48683,7206,92594,16046,59.9,109,stable,43.5,80,112655,0,0
NC,"Hertford County, North Carolina",5475,2134,3341,37091,33008,8458,1524,10779,1411,19237,2935,68.3,22,stable,48.4,16,24184,0,0
NC,"Hoke County, North Carolina",11047,4612,6435,37093,41542,18294,3161,21943,3481,40237,6642,96.9,34,stable,75.3,24,52671,0,0
NC,"Hyde County, North Carolina",890,278,612,37095,42897,1997,458,2152,420,4149,878,83.6,6,stable,54.9,4,5526,0,0
NC,"Iredell County, North Carolina",22803,9533,13270,37097,52306,69972,10617,72976,10314,142948,20931,73.9,131,stable,52.2,92,169866,0,0
NC,"Jackson County, North Carolina",8139,3911,4228,37099,38015,16388,3487,17794,2816,34182,6303,64.9,33,stable,50.1,25,41265,0,0
NC,"Johnston County, North Carolina",27086,12599,14487,37101,50512,72358,14182,77916,12270,150274,26452,70.1,116,stable,58.4,94,185660,0,0
NC,"Jones County, North Carolina",2173,889,1284,37103,34005,3862,1023,4482,696,8344,1719,86.4,13,stable,65.9,10,10013,0,0
NC,"Lee County, North Carolina",10533,4363,6170,37105,45608,22501,5700,24947,5037,47448,10737,76.6,51,falling,54.7,36,59660,0,1
NC,"Lenoir County, North Carolina",13401,5724,7677,37107,34717,21830,5509,26143,4306,47973,9815,73,57,stable,53.2,42,58106,0,0
NC,"Lincoln County, North Carolina",12243,5509,6734,37109,49215,33425,5657,34528,5400,67953,11057,71.6,65,stable,51.8,47,81035,0,0
NC,"McDowell County, North Carolina",8897,4138,4759,37111,35965,18526,3360,19508,2625,38034,5985,88.6,54,stable,58.1,35,44989,0,0
NC,"Macon County, North Carolina",6401,2951,3450,37113,39133,13028,3366,14225,3072,27253,6438,75.4,46,stable,57.9,35,34201,0,0
NC,"Madison County, North Carolina",3616,1490,2126,37115,37904,8835,1533,9401,1025,18236,2558,56.5,18,stable,47,14,21139,0,0
NC,"Martin County, North Carolina",5007,2191,2816,37117,35080,9207,1912,10402,2070,19609,3982,68,24,stable,47.2,16,23357,0,0
NC,"Mecklenburg County, North Carolina",148326,65072,83254,37119,56854,394554,79148,440912,70014,835466,149162,59.4,452,stable,41.9,314,1034070,0,0
NC,"Mitchell County, North Carolina",2910,1265,1645,37121,37391,6327,1139,6653,1084,12980,2223,81.4,20,stable,63.3,16,15246,0,0
NC,"Montgomery County, North Carolina",6716,2942,3774,37123,32500,10297,2606,11294,2567,21591,5173,71.3,26,stable,49.4,18,27548,0,0
NC,"Moore County, North Carolina",13808,5800,8008,37125,50998,37266,5229,41237,5632,78503,10861,73.7,108,stable,48.5,74,94352,0,0
NC,"Nash County, North Carolina",17141,7079,10062,37127,42713,37616,6774,41977,6855,79593,13629,72.8,85,stable,58,68,93919,0,0
NC,"New Hanover County, North Carolina",36717,15886,20831,37129,50088,84864,16254,96287,13171,181151,29425,66.2,158,stable,48.7,115,220358,0,0
NC,"Northampton County, North Carolina",5658,2269,3389,37131,30429,7822,1734,9211,1484,17033,3218,72.4,24,stable,56.8,19,20426,0,0
NC,"Onslow County, North Carolina",24916,10709,14207,37133,46335,60931,9861,73645,8594,134576,18455,85.5,101,stable,61.5,70,186311,0,0
NC,"Orange County, North Carolina",20236,8668,11568,37135,59290,58773,6925,66098,6134,124871,13059,57.5,69,stable,42.8,50,141354,0,0
NC,"Pamlico County, North Carolina",1674,715,959,37137,43444,5137,963,5386,863,10523,1826,83.3,19,stable,42.2,10,12781,0,0
NC,"Pasquotank County, North Carolina",7256,2976,4280,37139,45378,15561,2888,17386,2810,32947,5698,68.8,32,stable,59.5,27,39829,0,0
NC,"Pender County, North Carolina",9925,4191,5734,37141,44828,21808,4329,23069,4293,44877,8622,70.9,49,stable,51.1,36,57611,0,0
NC,"Perquimans County, North Carolina",2626,1160,1466,37143,44329,5224,1107,5893,1157,11117,2264,68.9,15,stable,48.2,10,13440,0,0
NC,"Person County, North Carolina",7708,3574,4134,37145,42105,15990,2909,17796,2138,33786,5047,84.6,42,stable,63.4,32,39259,0,0
NC,"Pitt County, North Carolina",42743,18057,24686,37147,41119,69019,12197,79254,12067,148273,24264,62.9,95,stable,48,71,175842,0,0
NC,"Polk County, North Carolina",2790,1322,1468,37149,46528,8521,1162,8990,1384,17511,2546,50.3,19,stable,40.8,15,20366,0,0
NC,"Randolph County, North Carolina",24770,11758,13012,37151,41947,57242,12444,60274,11241,117516,23685,86.5,147,stable,60.2,103,142799,0,0
NC,"Richmond County, North Carolina",11465,5045,6420,37153,32687,17202,4131,19468,3935,36670,8066,85.7,49,stable,64.5,37,45437,0,0
NC,"Robeson County, North Carolina",41538,18723,22815,37155,30608,49747,13868,56491,12539,106238,26407,69.2,95,stable,58.4,79,134197,0,0
NC,"Rockingham County, North Carolina",16968,7168,9800,37157,38126,38006,6007,41536,5754,79542,11761,89.9,113,stable,60.2,75,91758,0,0
NC,"Rowan County, North Carolina",24194,10656,13538,37159,43069,55135,11191,60050,9456,115185,20647,85.9,144,stable,58.5,98,139142,0,0
NC,"Rutherford County, North Carolina",13077,5970,7107,37161,35630,26825,5113,29291,4740,56116,9853,79.4,76,stable,56.3,54,66390,0,0
NC,"Sampson County, North Carolina",16050,7577,8473,37163,35490,24731,6401,26787,5332,51518,11733,77.7,60,stable,60.4,46,63724,0,0
NC,"Scotland County, North Carolina",10504,4613,5891,37165,30958,13319,2850,15365,2603,28684,5453,84.5,36,stable,63.6,27,35509,0,0
NC,"Stanly County, North Carolina",10356,4702,5654,37167,40910,25359,3955,25850,4026,51209,7981,80.4,64,stable,55.8,43,60714,0,0
NC,"Stokes County, North Carolina",7826,3615,4211,37169,40696,19445,3237,20499,3040,39944,6277,90.6,58,stable,65.5,41,46351,0,0
NC,"Surry County, North Carolina",14195,6484,7711,37171,36164,29052,6524,31220,5627,60272,12151,82.9,83,stable,67.8,68,72743,0,0
NC,"Swain County, North Carolina",3409,1553,1856,37173,33931,5139,1619,5775,1441,10914,3060,95.5,18,stable,66.8,13,14434,0,0
NC,"Transylvania County, North Carolina",4017,1819,2198,37175,45114,12650,3093,13899,2805,26549,5898,53.6,33,stable,37.2,23,33211,0,0
NC,"Tyrrell County, North Carolina",779,326,453,37177,32361,1415,413,1396,343,2811,756,97.5,6,stable,60,3,4070,0,0
NC,"Union County, North Carolina",21416,10081,11335,37179,65903,91176,13811,95909,11579,187085,25390,62.9,113,stable,46.5,80,222742,0,0
NC,"Vance County, North Carolina",11064,4926,6138,37181,33316,16836,3892,20309,3338,37145,7230,71,39,stable,53.2,29,44568,0,0
NC,"Wake County, North Carolina",107687,49166,58521,37183,67309,410336,59667,444583,52804,854919,112471,55.9,406,falling,38.8,274,1024198,0,1
NC,"Warren County, North Carolina",4692,2290,2402,37185,34254,7584,1876,8704,1288,16288,3164,81.7,26,stable,71.8,23,20155,0,0
NC,"Washington County, North Carolina",2737,841,1896,37187,34538,5022,764,5787,957,10809,1721,58.6,11,stable,45.4,9,12385,0,0
NC,"Watauga County, North Carolina",14726,7773,6953,37189,37656,23127,2754,23493,2583,46620,5337,51.4,26,stable,33.5,17,52906,0,0
NC,"Wayne County, North Carolina",27037,11517,15520,37191,40390,48265,9082,53636,8801,101901,17883,76.6,105,stable,58.2,79,124132,0,0
NC,"Wilkes County, North Carolina",15791,7521,8270,37193,33232,27936,5578,30011,4561,57947,10139,77.2,75,stable,58.5,57,68502,0,0
NC,"Wilson County, North Carolina",18475,8116,10359,37195,39847,30989,7122,35996,6337,66985,13459,71.2,71,stable,55.8,55,81714,0,0
NC,"Yadkin County, North Carolina",7643,3528,4115,37197,37796,15503,3106,16609,2487,32112,5593,82.2,42,stable,52.6,27,37585,0,0
NC,"Yancey County, North Carolina",3775,1653,2122,37199,37484,6997,1488,7526,1415,14523,2903,86.3,25,stable,53.1,15,17587,0,0
ND,"Barnes County, North Dakota",841,396,445,38003,53141,4956,505,5111,332,10067,837,64.5,10,falling,41.8,7,11099,0,1
ND,"Bottineau County, North Dakota",540,188,352,38009,56349,3109,328,2722,306,5831,634,58.3,6,stable,37.8,5,6716,0,0
ND,"Burleigh County, North Dakota",6946,3052,3894,38015,65254,39076,3389,41128,2750,80204,6139,52.2,49,stable,34.4,32,92991,0,0
ND,"Cass County, North Dakota",19082,8990,10092,38017,53289,73605,7721,74144,5868,147749,13589,59.8,80,rising,37.3,50,171512,1,0
ND,"Grand Forks County, North Dakota",11223,5076,6147,38035,48676,31352,2691,30830,2197,62182,4888,59.7,36,stable,42.6,26,70916,0,0
ND,"Griggs County, North Dakota",179,78,101,38039,48355,1047,98,1002,91,2049,189,*,3 or fewer,stable,76.8,4,2314,0,0
ND,"McHenry County, North Dakota",738,333,405,38049,57386,2706,302,2545,185,5251,487,63.6,6,stable,41.7,4,5968,0,0
ND,"McLean County, North Dakota",1072,441,631,38055,55686,4285,392,4129,455,8414,847,53.4,8,stable,35.1,5,9744,0,0
ND,"Mercer County, North Dakota",693,217,476,38057,72704,4014,424,3668,415,7682,839,50.6,6,stable,36.8,4,8853,0,0
ND,"Morton County, North Dakota",2270,1079,1191,38059,62418,13459,1052,13184,743,26643,1795,68.7,24,stable,45.2,16,30310,0,0
ND,"Mountrail County, North Dakota",1226,608,618,38061,68188,4094,916,3434,711,7528,1627,70.9,6,stable,48.9,4,10331,0,0
ND,"Pembina County, North Dakota",454,193,261,38067,53504,3282,335,3222,203,6504,538,65.2,8,stable,56.7,7,7091,0,0
ND,"Ramsey County, North Dakota",1118,565,553,38071,50841,4968,632,4974,491,9942,1123,73.7,11,stable,53.2,8,11630,0,0
ND,"Ransom County, North Dakota",490,191,299,38073,56500,2547,172,2450,132,4997,304,67.9,6,stable,55.3,5,5448,0,0
ND,"Richland County, North Dakota",1633,659,974,38077,55390,7869,465,7377,436,15246,901,45.2,9,stable,33.2,6,16402,0,0
ND,"Rolette County, North Dakota",5054,2207,2847,38079,33277,4522,2528,5293,2031,9815,4559,76.5,10,stable,72.2,9,14649,0,0
ND,"Stark County, North Dakota",1866,755,1111,38089,72099,13171,1442,12384,1177,25555,2619,42.7,13,stable,32.4,10,32154,0,0
ND,"Stutsman County, North Dakota",2130,854,1276,38093,52359,9124,970,9324,745,18448,1715,56.5,17,stable,51.2,16,21103,0,0
ND,"Traill County, North Dakota",804,436,368,38097,54960,3777,223,3741,156,7518,379,62,7,rising,41.6,5,8014,1,0
ND,"Walsh County, North Dakota",1112,464,648,38099,49411,4913,667,4880,367,9793,1034,56.7,10,stable,42.8,8,10897,0,0
ND,"Ward County, North Dakota",4919,1861,3058,38101,61393,28609,3115,29757,2358,58366,5473,64.6,41,stable,44.2,29,71275,0,0
ND,"Wells County, North Dakota",226,110,116,38103,48098,1929,180,1857,153,3786,333,40.6,4,stable,45.7,4,4168,0,0
ND,"Williams County, North Dakota",2913,1402,1511,38105,88013,14385,1497,11912,1468,26297,2965,53.9,14,stable,46.5,12,35294,0,0
NE,"Adams County, Nebraska",3499,1490,2009,31001,50635,13894,1771,14127,1366,28021,3137,62.7,24,stable,45,18,31587,0,0
NE,"Antelope County, Nebraska",811,353,458,31003,45609,2880,305,2920,284,5800,589,51.1,6,stable,39.7,4,6414,0,0
NE,"Box Butte County, Nebraska",1886,758,1128,31013,51691,5247,428,4956,515,10203,943,48.9,7,stable,31.2,5,11337,0,0
NE,"Buffalo County, Nebraska",5978,2737,3241,31019,53624,21439,2104,22245,1568,43684,3672,49.3,23,stable,36,16,48863,0,0
NE,"Burt County, Nebraska",620,265,355,31021,47429,2967,283,2957,338,5924,621,66.2,7,stable,58.7,6,6585,0,0
NE,"Butler County, Nebraska",682,309,373,31023,51027,3741,371,3701,272,7442,643,48,6,stable,36.9,5,8115,0,0
NE,"Cass County, Nebraska",1556,739,817,31025,65619,11685,773,11691,780,23376,1553,65.5,19,stable,50.4,15,25512,0,0
NE,"Cedar County, Nebraska",864,385,479,31027,52250,4089,267,3947,224,8036,491,32.5,5,stable,28.2,4,8564,0,0
NE,"Chase County, Nebraska",337,161,176,31029,52422,1627,243,1704,256,3331,499,77.6,5,stable,59.1,4,3956,0,0
NE,"Cherry County, Nebraska",648,175,473,31031,48750,2495,209,2679,328,5174,537,38.1,3,stable,36.4,3,5848,0,0
NE,"Cheyenne County, Nebraska",1150,420,730,31033,53814,4538,380,4707,353,9245,733,60.7,8,stable,47.2,6,10167,0,0
NE,"Clay County, Nebraska",580,233,347,31035,51470,2836,362,2704,376,5540,738,54.1,5,stable,41.9,4,6309,0,0
NE,"Colfax County, Nebraska",1374,675,699,31037,51367,4633,786,4333,680,8966,1466,45.9,5,stable,33.1,4,10520,0,0
NE,"Cuming County, Nebraska",1071,376,695,31039,50013,4041,437,4058,391,8099,828,41.6,6,stable,34.1,5,9125,0,0
NE,"Custer County, Nebraska",1200,526,674,31041,46468,4558,716,4818,587,9376,1303,48.3,8,stable,42.2,7,10806,0,0
NE,"Dakota County, Nebraska",3528,1510,2018,31043,49786,8405,1570,8872,1735,17277,3305,73,15,stable,53,11,20781,0,0
NE,"Dawes County, Nebraska",1428,531,897,31045,41038,3715,645,3960,741,7675,1386,43.8,5,stable,28.9,4,9055,0,0
NE,"Dawson County, Nebraska",3618,1439,2179,31047,48329,10328,1645,10323,1499,20651,3144,45.9,13,stable,36.9,10,23886,0,0
NE,"Dixon County, Nebraska",683,309,374,31051,51223,2521,356,2582,322,5103,678,63.3,6,stable,35.5,3,5797,0,0
NE,"Dodge County, Nebraska",4061,1819,2242,31053,49068,15521,2220,16362,2033,31883,4253,70.2,36,stable,51.8,27,36706,0,0
NE,"Douglas County, Nebraska",76738,33674,43064,31055,54659,228496,32282,242959,27736,471455,60018,69.5,338,stable,51,245,550064,0,0
NE,"Fillmore County, Nebraska",514,167,347,31059,52316,2426,307,2483,249,4909,556,48.1,5,stable,40.6,4,5619,0,0
NE,"Gage County, Nebraska",2080,925,1155,31067,50010,9878,830,10192,633,20070,1463,59.5,19,stable,40.6,13,21900,0,0
NE,"Hall County, Nebraska",9092,3927,5165,31079,49252,25029,4904,25624,4458,50653,9362,57.8,38,stable,38.9,25,61680,0,0
NE,"Hamilton County, Nebraska",780,303,477,31081,59311,4189,305,4244,219,8433,524,48,6,stable,34.1,4,9190,0,0
NE,"Holt County, Nebraska",1209,512,697,31089,46728,4599,482,4691,461,9290,943,49.5,8,stable,46.6,8,10313,0,0
NE,"Howard County, Nebraska",658,333,325,31093,50030,2996,238,2953,140,5949,378,54.1,5,stable,43.2,4,6409,0,0
NE,"Jefferson County, Nebraska",909,361,548,31095,43008,3352,253,3390,325,6742,578,65.2,8,stable,50.1,6,7263,0,0
NE,"Johnson County, Nebraska",471,214,257,31097,45429,1770,187,1845,212,3615,399,97.5,7,stable,46.6,3,5173,0,0
NE,"Kearney County, Nebraska",408,181,227,31099,51934,2928,277,2976,285,5904,562,60.8,6,stable,47.6,4,6585,0,0
NE,"Keith County, Nebraska",931,393,538,31101,41781,3516,521,3500,547,7016,1068,49.2,7,stable,37.9,5,8063,0,0
NE,"Kimball County, Nebraska",496,205,291,31105,40242,1535,289,1542,296,3077,585,60.6,4,stable,49.9,3,3689,0,0
NE,"Knox County, Nebraska",1117,426,691,31107,45411,3614,462,3751,498,7365,960,59.3,8,stable,51.7,8,8543,0,0
NE,"Lancaster County, Nebraska",41796,18624,23172,31109,51830,129832,16174,135393,12304,265225,28478,57.3,155,stable,41.6,112,306468,0,0
NE,"Lincoln County, Nebraska",4488,1775,2713,31111,50194,15665,1904,15915,2019,31580,3923,57.1,26,stable,44.2,20,35656,0,0
NE,"Madison County, Nebraska",5119,2075,3044,31119,50218,15094,2026,15516,1830,30610,3856,61.4,25,stable,40.5,17,35039,0,0
NE,"Merrick County, Nebraska",667,344,323,31121,51012,3455,310,3494,402,6949,712,68,8,stable,44.9,5,7787,0,0
NE,"Nemaha County, Nebraska",574,300,274,31127,49656,3100,292,3377,281,6477,573,62.5,6,stable,37.4,4,7046,0,0
NE,"Nuckolls County, Nebraska",501,182,319,31129,40488,1886,260,1979,184,3865,444,64.8,5,stable,45,4,4329,0,0
NE,"Otoe County, Nebraska",1696,740,956,31131,50275,6900,821,7198,634,14098,1455,59.6,13,rising,46.7,10,15984,1,0
NE,"Phelps County, Nebraska",706,213,493,31137,50404,4142,364,4120,359,8262,723,44.3,6,stable,39.1,5,9296,0,0
NE,"Pierce County, Nebraska",417,174,243,31139,54482,3276,287,3320,167,6596,454,56,6,stable,46.2,5,7208,0,0
NE,"Platte County, Nebraska",2728,1336,1392,31141,56318,14472,1958,14421,1492,28893,3450,54.9,21,stable,40.8,16,32847,0,0
NE,"Polk County, Nebraska",389,184,205,31143,57312,2359,222,2388,187,4747,409,65.7,5,stable,48,4,5202,0,0
NE,"Red Willow County, Nebraska",1118,572,546,31145,42931,4618,689,4948,430,9566,1119,49.5,8,stable,46.5,8,10829,0,0
NE,"Richardson County, Nebraska",1557,690,867,31147,42750,3711,319,3732,284,7443,603,60.6,8,stable,51.7,7,8094,0,0
NE,"Saline County, Nebraska",1492,705,787,31151,51738,6427,857,6226,541,12653,1398,79.5,12,stable,49.8,8,14282,0,0
NE,"Sarpy County, Nebraska",10684,4831,5853,31153,70543,75886,5603,78430,5281,154316,10884,65.1,81,stable,49.9,62,175692,0,0
NE,"Saunders County, Nebraska",2001,911,1090,31155,60854,9715,720,9515,664,19230,1384,60.8,17,stable,46.2,13,21016,0,0
NE,"Scotts Bluff County, Nebraska",4877,2163,2714,31157,45992,14776,2704,16164,2443,30940,5147,45.9,22,stable,34.6,17,36261,0,0
NE,"Seward County, Nebraska",1467,738,729,31159,59662,8006,588,7718,420,15724,1008,44.2,9,stable,32.2,7,17110,0,0
NE,"Sherman County, Nebraska",411,126,285,31163,46366,1379,133,1430,107,2809,240,*,3 or fewer,stable,66.1,3,3091,0,0
NE,"Thurston County, Nebraska",2090,947,1143,31173,41266,2351,1050,2548,941,4899,1991,65.1,4,stable,55.8,4,7064,0,0
NE,"Washington County, Nebraska",1880,595,1285,31177,65370,9329,588,9285,867,18614,1455,43.1,11,stable,40.4,10,20248,0,0
NE,"Webster County, Nebraska",459,235,224,31181,40256,1593,163,1667,187,3260,350,68.8,5,stable,45.9,3,3625,0,0
NE,"York County, Nebraska",1393,621,772,31185,51802,6087,621,6010,538,12097,1159,36.8,7,stable,28.2,5,13806,0,0
NH,"Belknap County, New Hampshire",6214,2893,3321,33001,62159,25364,3734,27430,3127,52794,6861,65.6,56,falling,55.2,46,60641,0,1
NH,"Carroll County, New Hampshire",4484,2015,2469,33003,53306,19928,3653,20392,3124,40320,6777,65.8,53,stable,42.9,35,47285,0,0
NH,"Cheshire County, New Hampshire",8467,3684,4783,33005,57782,32472,4282,35847,3084,68319,7366,66.6,63,stable,45.4,43,75909,0,0
NH,"Coos County, New Hampshire",4257,1950,2307,33007,42312,13183,1853,13622,1713,26805,3566,69.9,36,stable,54.8,27,31212,0,0
NH,"Grafton County, New Hampshire",9609,4252,5357,33009,55762,38402,5228,40032,4836,78434,10064,56.4,65,stable,38.6,44,89320,0,0
NH,"Hillsborough County, New Hampshire",34681,15707,18974,33011,71244,178942,19692,185709,15685,364651,35377,66.2,283,stable,46.1,194,406678,0,0
NH,"Merrimack County, New Hampshire",12840,5578,7262,33013,65983,63596,6756,68239,5583,131835,12339,66.9,118,stable,46.6,84,147994,0,0
NH,"Rockingham County, New Hampshire",16192,7315,8877,33015,81198,134871,11591,140369,10100,275240,21691,72.5,242,stable,49.4,163,301777,0,0
NH,"Strafford County, New Hampshire",12997,5717,7280,33017,60711,53304,6948,57377,6285,110681,13233,75,96,stable,53.3,68,126825,0,0
NH,"Sullivan County, New Hampshire",4099,1959,2140,33019,56032,18333,2630,19593,2148,37926,4778,72.6,44,stable,51.7,32,42967,0,0
NJ,"Atlantic County, New Jersey",40868,18753,22115,34001,54461,112340,19078,124944,16097,237284,35175,69.9,230,falling,47.9,156,274219,0,1
NJ,"Bergen County, New Jersey",67959,29262,38697,34003,85806,391824,53563,426933,48157,818757,101720,50.9,580,falling,34.7,402,938506,0,1
NJ,"Burlington County, New Jersey",27881,12238,15643,34005,78621,192963,16726,213627,12770,406590,29496,65.1,342,stable,44.2,232,450226,0,0
NJ,"Camden County, New Jersey",66802,28813,37989,34007,62185,212875,31229,239130,23082,452005,54311,71.9,406,stable,48.9,275,510923,0,0
NJ,"Cape May County, New Jersey",9744,4179,5565,34009,57637,40486,4651,44888,3602,85374,8253,83.5,136,stable,54.9,90,94727,0,0
NJ,"Cumberland County, New Jersey",25760,11633,14127,34011,49984,59423,10828,66601,8609,126024,19437,73.4,122,stable,50.7,84,155854,0,0
NJ,"Essex County, New Jersey",133788,57543,76245,34013,53976,303430,68533,350254,57907,653684,126440,50.9,399,falling,37.1,289,797434,0,1
NJ,"Gloucester County, New Jersey",23200,9915,13285,34015,76727,128535,11903,138803,9679,267338,21582,80.5,250,stable,55.5,172,291479,0,0
NJ,"Hudson County, New Jersey",114900,50273,64627,34017,59741,258423,69020,272486,59125,530909,128145,48.8,279,falling,36.5,206,674836,0,1
NJ,"Hunterdon County, New Jersey",5379,2236,3143,34019,105444,56714,3170,60109,2305,116823,5475,54.4,80,falling,37.8,55,125488,0,1
NJ,"Mercer County, New Jersey",40354,18218,22136,34021,72804,154154,21815,171281,15938,325435,37753,59.1,235,falling,38.2,152,371398,0,1
NJ,"Middlesex County, New Jersey",70908,31792,39116,34023,79593,350206,51055,376132,43310,726338,94365,53.4,459,stable,37,319,840900,0,0
NJ,"Monmouth County, New Jersey",46492,20092,26400,34025,85242,273118,31154,295155,25547,568273,56701,63.9,475,stable,42.8,317,628715,0,0
NJ,"Morris County, New Jersey",22068,9710,12358,34027,100214,222190,19830,235146,17038,457336,36868,49.6,287,falling,34.8,201,499509,0,1
NJ,"Ocean County, New Jersey",64795,29231,35564,34029,61994,251605,26431,277128,22954,528733,49385,71.4,645,falling,47.7,442,588721,0,1
NJ,"Passaic County, New Jersey",83203,37009,46194,34031,59739,199460,45684,221524,37168,420984,82852,53.8,276,falling,39.3,202,510916,0,1
NJ,"Salem County, New Jersey",8602,3826,4776,34033,61831,27515,3442,30248,2723,57763,6165,72.8,62,falling,48.1,41,64180,0,1
NJ,"Somerset County, New Jersey",16479,7340,9139,34035,100667,145888,13951,155658,12324,301546,26275,48.7,171,falling,35.3,122,333654,0,1
NJ,"Sussex County, New Jersey",8237,3862,4375,34037,86565,65217,6547,67862,4954,133079,11501,64.2,106,falling,45.2,74,143673,0,1
NJ,"Union County, New Jersey",59034,24322,34712,34039,69594,220599,44217,241572,37837,462171,82054,47.9,274,falling,35.8,207,555786,0,1
NJ,"Warren County, New Jersey",8394,3681,4713,34041,70471,46651,4979,50057,4518,96708,9497,65.4,85,falling,45.6,59,106869,0,1
NM,"Bernalillo County, New Mexico",128917,59967,68950,35001,47725,272940,52028,296915,44601,569855,96629,39.4,277,falling,31.2,216,676685,0,1
NM,"Chaves County, New Mexico",14013,6312,7701,35005,40630,26078,5891,27592,5260,53670,11151,47.5,36,falling,40.9,31,65764,0,1
NM,"Cibola County, New Mexico",7489,3567,3922,35006,34565,9819,2968,10636,2213,20455,5181,50.6,15,stable,24.7,7,27329,0,0
NM,"Colfax County, New Mexico",2490,1121,1369,35007,32380,5246,879,5714,702,10960,1581,38.1,9,stable,25.3,6,12414,0,0
NM,"Curry County, New Mexico",10338,4527,5811,35009,41084,19743,4372,20736,3137,40479,7509,46.8,21,stable,36.7,17,50398,0,0
NM,"Doña Ana County, New Mexico",58846,27487,31359,35013,38853,83656,18726,90314,17907,173970,36633,42.6,92,stable,33.8,72,214295,0,0
NM,"Eddy County, New Mexico",6237,2460,3777,35015,56618,23842,4068,23388,3791,47230,7859,47.3,29,stable,38.3,24,57578,0,0
NM,"Grant County, New Mexico",5940,2771,3169,35017,38311,12900,1315,13334,1189,26234,2504,44.7,22,stable,30,15,28609,0,0
NM,"Lea County, New Mexico",9859,3934,5925,35025,57533,27173,6335,26439,6606,53612,12941,57.7,34,falling,40.8,24,71180,0,1
NM,"Lincoln County, New Mexico",3271,1479,1792,35027,40708,8397,1373,8737,1283,17134,2656,45.4,17,stable,31.9,11,19420,0,0
NM,"Los Alamos County, New Mexico",1092,429,663,35028,101934,8611,523,8183,510,16794,1033,26.5,7,stable,15.8,4,17785,0,0
NM,"Luna County, New Mexico",7236,3080,4156,35029,27476,9539,2561,10103,2219,19642,4780,56.8,22,stable,41,15,24518,0,0
NM,"McKinley County, New Mexico",27493,13235,14258,35031,28772,23399,12014,26997,11227,50396,23241,13.5,9,falling,11.6,7,76708,0,1
NM,"Otero County, New Mexico",14387,6638,7749,35035,39775,24419,4996,26535,4567,50954,9563,58.5,45,stable,43.2,33,64362,0,0
NM,"Quay County, New Mexico",1484,640,844,35037,29113,3576,613,4109,365,7685,978,62.1,9,stable,51.2,7,8455,0,0
NM,"Rio Arriba County, New Mexico",9413,4770,4643,35039,36098,15072,4355,16670,3586,31742,7941,34.8,16,stable,30.3,14,39465,0,0
NM,"Roosevelt County, New Mexico",4918,2164,2754,35041,35546,7984,1736,8234,1470,16218,3206,55.2,10,stable,37.2,7,19120,0,0
NM,"Sandoval County, New Mexico",19305,8939,10366,35043,58982,57383,9182,61538,7749,118921,16931,40.4,58,stable,30.9,42,139394,0,0
NM,"San Juan County, New Mexico",24755,11972,12783,35045,48671,46708,14508,50124,12443,96832,26951,44,53,stable,30.1,36,118737,0,0
NM,"San Miguel County, New Mexico",8093,3544,4549,35047,29237,11235,2535,11977,2358,23212,4893,37.3,14,stable,34.4,12,27967,0,0
NM,"Santa Fe County, New Mexico",22477,10373,12104,35049,54315,56164,13908,63236,11977,119400,25885,31.7,59,stable,23,42,148686,0,0
NM,"Sierra County, New Mexico",2360,1347,1013,35051,29356,4718,973,5002,681,9720,1654,55.1,16,stable,49,14,11282,0,0
NM,"Socorro County, New Mexico",4278,1928,2350,35053,34037,7482,1584,7246,1080,14728,2664,47.8,10,stable,35.9,7,17256,0,0
NM,"Taos County, New Mexico",7909,3785,4124,35055,36582,13285,2640,14135,2679,27420,5319,35,16,stable,27.5,13,32907,0,0
NM,"Torrance County, New Mexico",4833,2325,2508,35057,32083,5959,1566,6662,909,12621,2475,49,11,stable,40.4,9,15485,0,0
NM,"Valencia County, New Mexico",17604,8399,9205,35061,41703,30560,6254,33613,4273,64173,10527,50.8,42,stable,41.9,34,75737,0,0
NV,"Churchill County, Nevada",3802,1765,2037,32001,47415,9756,1871,9845,1873,19601,3744,__,__,__,59.9,18,24200,0,0
NV,"Clark County, Nevada",315358,147575,167783,32003,51575,799278,201993,830625,180211,1629903,382204,__,__,__,48.1,901,2114801,0,0
NV,"Douglas County, Nevada",4984,2264,2720,32005,58535,19911,3602,20431,2952,40342,6554,__,__,__,40.9,32,47710,0,0
NV,"Elko County, Nevada",5574,2675,2899,32007,71799,22496,3962,20493,3991,42989,7953,__,__,__,39.9,15,51935,0,0
NV,"Humboldt County, Nevada",1762,802,960,32013,65212,7339,1429,6497,1574,13836,3003,__,__,__,48.4,7,17019,0,0
NV,"Lyon County, Nevada",8482,3749,4733,32019,47255,21106,4645,21605,3982,42711,8627,__,__,__,61.2,41,52585,0,0
NV,"Mineral County, Nevada",907,429,478,32021,38923,1926,446,1816,296,3742,742,__,__,__,63.6,5,4478,0,0
NV,"Nye County, Nevada",7658,3541,4117,32023,41712,17457,3427,17963,3405,35420,6832,__,__,__,67.9,52,42477,0,0
NV,"Pershing County, Nevada",832,350,482,32027,45230,1995,525,1846,413,3841,938,__,__,__,61,4,6634,0,0
NV,"Washoe County, Nevada",65248,30454,34794,32031,52870,176960,39625,183055,32403,360015,72028,__,__,__,41.7,182,446903,0,0
NV,"White Pine County, Nevada",987,381,606,32033,57122,3873,526,3532,731,7405,1257,__,__,__,46.1,6,9811,0,0
NV,"Carson City, Nevada",8787,3992,4795,32510,47668,21461,4907,22411,3802,43872,8709,__,__,__,51.8,39,54521,0,0
NY,"Albany County, New York",39349,17368,21981,36001,59887,136092,11096,149544,7079,285636,18175,73,258,stable,51.2,181,309381,0,0
NY,"Allegany County, New York",7285,3424,3861,36003,42776,21718,2411,21566,1902,43284,4313,76.9,46,stable,50.7,30,47462,0,0
NY,"Bronx County, New York",427574,181112,246462,36005,34299,546151,112171,667792,79977,1213943,192148,50.4,641,stable,34.5,438,1455444,0,0
NY,"Broome County, New York",33615,15839,17776,36007,46261,87879,8190,93618,5438,181497,13628,61.7,160,stable,42.1,111,196567,0,0
NY,"Cattaraugus County, New York",13954,6444,7510,36009,42601,34324,4389,35911,3604,70235,7993,75.8,77,stable,50.9,52,77922,0,0
NY,"Cayuga County, New York",9010,4089,4921,36011,52082,34015,3875,35593,2514,69608,6389,77.7,79,stable,49.5,51,78288,0,0
NY,"Chautauqua County, New York",23894,10816,13078,36013,42993,58267,5797,61793,4155,120060,9952,67.9,122,stable,49.4,90,130779,0,0
NY,"Chemung County, New York",13044,5401,7643,36015,50320,37175,2867,41183,2753,78358,5620,77,88,stable,56.2,66,87071,0,0
NY,"Chenango County, New York",7741,3403,4338,36017,45668,21882,2543,22703,1852,44585,4395,71.9,49,stable,52.1,35,48844,0,0
NY,"Clinton County, New York",12163,5245,6918,36019,49930,35166,2815,37281,1930,72447,4745,95.1,90,stable,53.9,50,81251,0,0
NY,"Columbia County, New York",7067,3251,3816,36021,59105,27711,2424,28700,1636,56411,4060,79,74,rising,55.7,52,61509,1,0
NY,"Cortland County, New York",6675,2638,4037,36023,49514,21754,1994,23643,1182,45397,3176,79,43,stable,59.1,32,48494,0,0
NY,"Delaware County, New York",6799,3306,3493,36025,43720,21050,2238,21095,1983,42145,4221,68.9,51,stable,46.3,34,46053,0,0
NY,"Dutchess County, New York",26229,11831,14398,36027,71904,128932,12845,138223,9320,267155,22165,64.7,226,stable,44,151,295754,0,0
NY,"Erie County, New York",134715,59086,75629,36029,51247,407808,30636,449962,21593,857770,52229,76.2,886,stable,52.6,620,922578,0,0
NY,"Essex County, New York",3894,1756,2138,36031,52758,16571,1724,17184,1210,33755,2934,68,40,stable,46.7,28,38478,0,0
NY,"Franklin County, New York",9213,4383,4830,36033,47923,20904,2679,20771,2095,41675,4774,77.9,46,stable,56.4,33,50660,0,0
NY,"Fulton County, New York",9100,4176,4924,36035,46969,23688,2953,25023,2103,48711,5056,80,58,stable,47.6,35,53992,0,0
NY,"Genesee County, New York",7748,3521,4227,36037,50880,26500,2833,27875,1715,54375,4548,80.4,61,stable,58.2,45,58937,0,0
NY,"Greene County, New York",5813,2342,3471,36039,50278,20501,1739,21459,1697,41960,3436,72.7,51,stable,54.1,38,47625,0,0
NY,"Hamilton County, New York",609,317,292,36041,48243,2029,353,2217,137,4246,490,78.4,7,stable,57.6,5,4712,0,0
NY,"Herkimer County, New York",9145,4089,5056,36043,46229,27782,3525,30157,1908,57939,5433,71.1,63,stable,44.2,39,63100,0,0
NY,"Jefferson County, New York",16938,7850,9088,36045,49505,45675,4905,52114,3727,97789,8632,79.6,88,stable,50.4,56,117635,0,0
NY,"Kings County, New York",597404,265335,332069,36047,48201,1049003,174172,1225395,136478,2274398,310650,49.3,1218,stable,33.4,824,2636735,0,0
NY,"Lewis County, New York",3238,1478,1760,36049,49819,12000,1526,12111,1135,24111,2661,62.7,22,stable,51.8,18,26957,0,0
NY,"Livingston County, New York",8681,3775,4906,36051,51734,28323,2011,30406,1597,58729,3608,67.2,52,stable,45.8,36,64717,0,0
NY,"Madison County, New York",8180,3640,4540,36053,54145,32642,2656,35019,1471,67661,4127,79.9,69,stable,56.2,49,71849,0,0
NY,"Monroe County, New York",110192,48774,61418,36055,52553,332340,26459,364808,18562,697148,45021,65.2,569,falling,46.4,405,749600,0,1
NY,"Montgomery County, New York",10053,4433,5620,36057,43764,21624,2545,23046,1810,44670,4355,81.1,53,stable,50.7,34,49642,0,0
NY,"Nassau County, New York",82146,35207,46939,36059,99465,595139,56534,648611,44182,1243750,100716,58.4,992,stable,34.8,605,1361350,0,0
NY,"New York County, New York",283590,123922,159668,36061,72871,681115,82373,793398,61737,1474513,144110,50.4,892,stable,32.2,573,1644518,0,0
NY,"Niagara County, New York",28816,12569,16247,36063,49449,95704,7556,103074,5711,198778,13267,80.1,227,stable,56.3,159,212652,0,0
NY,"Oneida County, New York",37760,17386,20374,36065,48246,101852,8753,109110,6067,210962,14820,79.9,245,stable,53,164,232500,0,0
NY,"Onondaga County, New York",69487,31279,38208,36067,55092,205440,17840,226524,13226,431964,31066,78.2,432,falling,52.4,289,468463,0,1
NY,"Ontario County, New York",10975,4935,6040,36069,57416,48533,4413,52278,2959,100811,7372,72.6,102,stable,48.3,67,109561,0,0
NY,"Orange County, New York",46731,21428,25303,36071,70848,163553,16726,173191,12204,336744,28930,67.8,248,stable,46.5,167,377647,0,0
NY,"Orleans County, New York",6173,2836,3337,36073,46359,17756,1951,18283,1388,36039,3339,89.8,47,stable,65.4,34,41582,0,0
NY,"Oswego County, New York",21615,10192,11423,36075,47860,54654,5561,56407,3777,111061,9338,92.6,126,stable,65.9,88,120146,0,0
NY,"Otsego County, New York",9275,4372,4903,36077,48588,26884,2673,29350,1834,56234,4507,66.5,55,stable,52,43,60636,0,0
NY,"Putnam County, New York",5212,2693,2519,36079,96148,45157,4059,46074,3540,91231,7599,69,77,stable,45.2,49,99042,0,0
NY,"Queens County, New York",343834,148985,194849,36081,57720,908912,199532,1019688,158193,1928600,357725,47.8,1161,falling,30.4,740,2339150,0,1
NY,"Rensselaer County, New York",19186,8695,10491,36083,60709,72733,5474,76458,3465,149191,8939,84,157,stable,58.4,109,160266,0,0
NY,"Richmond County, New York",58470,26399,32071,36085,73197,207045,19813,227781,13987,434826,33800,66.4,344,stable,45.6,233,474558,0,0
NY,"Rockland County, New York",46118,21825,24293,36087,84855,140580,15354,149776,12368,290356,27722,50.2,177,stable,32.9,116,326037,0,0
NY,"St. Lawrence County, New York",19494,9391,10103,36089,44705,47996,6068,50035,4289,98031,10357,82.4,108,falling,60.3,78,111007,0,1
NY,"Saratoga County, New York",14583,6435,8148,36091,71496,101757,6317,107942,4428,209699,10745,72.2,188,stable,52.4,135,226249,0,0
NY,"Schenectady County, New York",19028,8584,10444,36093,58114,68218,6160,74298,4396,142516,10556,70.9,135,stable,49.4,94,154604,0,0
NY,"Schoharie County, New York",3936,1911,2025,36095,51195,14353,1482,15212,754,29565,2236,65.1,29,stable,44.4,20,31330,0,0
NY,"Schuyler County, New York",2595,1062,1533,36097,47680,7916,1114,8390,669,16306,1783,70.3,18,stable,58.8,15,18186,0,0
NY,"Seneca County, New York",4081,1817,2264,36099,49292,14250,1859,14865,1491,29115,3350,81.3,37,stable,46.6,21,34833,0,0
NY,"Steuben County, New York",15888,7157,8731,36101,47280,43195,5104,45215,3995,88410,9099,80,104,stable,60,78,97631,0,0
NY,"Suffolk County, New York",103269,45309,57960,36103,88663,658711,72441,702061,52982,1360772,125423,69.7,1195,stable,43.8,751,1501587,0,0
NY,"Sullivan County, New York",12868,6015,6853,36105,50710,32306,4817,33861,3063,66167,7880,71.9,71,stable,51.6,51,74877,0,0
NY,"Tioga County, New York",4801,2062,2739,36107,57514,22472,2139,23751,1473,46223,3612,64.4,44,falling,46.2,31,49453,0,1
NY,"Tompkins County, New York",18547,8362,10185,36109,52624,47132,3403,50126,2334,97258,5737,57.6,54,stable,42.6,40,104926,0,0
NY,"Ulster County, New York",22290,10453,11837,36111,58918,77152,9528,83276,7023,160428,16551,71.5,164,stable,48.3,111,180143,0,0
NY,"Warren County, New York",7685,3218,4467,36113,56798,28599,3065,30686,2238,59285,5303,71.2,66,rising,45.8,42,64688,1,0
NY,"Washington County, New York",8004,3581,4423,36115,51143,26765,3041,27667,2246,54432,5287,88.7,71,falling,63.1,50,62230,0,1
NY,"Wayne County, New York",11541,5486,6055,36117,50798,40840,4148,42943,3420,83783,7568,72.8,84,stable,54.1,62,91446,0,0
NY,"Westchester County, New York",90752,39737,51015,36119,83958,407309,52745,455397,38864,862706,91609,53.2,615,stable,33.9,397,976396,0,0
NY,"Wyoming County, New York",4425,2081,2344,36121,52564,17208,1597,17779,1163,34987,2760,68.3,34,stable,53.2,26,41013,0,0
NY,"Yates County, New York",3446,1583,1863,36123,49510,9630,2453,10188,2558,19818,5011,73.2,25,stable,52.7,18,25048,0,0
OH,"Adams County, Ohio",6832,2970,3862,39001,35560,11652,2202,12190,1922,23842,4124,87.1,32,stable,74.5,27,28024,0,0
OH,"Allen County, Ohio",17713,8327,9386,39003,44103,44827,6106,47505,4170,92332,10276,70.4,90,stable,53.5,69,104425,0,0
OH,"Ashland County, Ohio",7569,3496,4073,39005,48003,22362,3470,23713,3127,46075,6597,61.2,41,stable,53.5,35,53213,0,0
OH,"Ashtabula County, Ohio",19266,8329,10937,39007,40544,41075,6662,43352,5542,84427,12204,79.2,103,stable,60,78,98632,0,0
OH,"Athens County, Ohio",18263,9227,9036,39009,33872,29257,2799,29877,2350,59134,5149,76.6,43,falling,63.1,34,65886,0,1
OH,"Auglaize County, Ohio",4010,1627,2383,39011,54274,21176,1386,21370,1430,42546,2816,68.1,40,stable,54.4,31,45876,0,0
OH,"Belmont County, Ohio",9553,4021,5532,39013,43833,28812,3352,30819,2786,59631,6138,61.3,60,stable,51,51,69154,0,0
OH,"Brown County, Ohio",6442,2678,3764,39015,45568,18406,3112,19983,2198,38389,5310,106.2,58,stable,75.1,41,43839,0,0
OH,"Butler County, Ohio",50312,21472,28840,39017,57540,163145,17748,173128,15304,336273,33052,75,285,stable,58.5,221,376353,0,0
OH,"Carroll County, Ohio",4317,1997,2320,39019,47075,12116,1990,12340,1632,24456,3622,79.7,31,stable,53.7,21,27811,0,0
OH,"Champaign County, Ohio",4756,2217,2539,39021,50974,17416,1966,18175,1353,35591,3319,64,31,stable,56.2,27,38987,0,0
OH,"Clark County, Ohio",24419,10932,13487,39023,43625,58470,6984,63812,5794,122282,12778,76.8,139,stable,60.7,112,135959,0,0
OH,"Clermont County, Ohio",21127,9318,11809,39025,60805,88894,9365,92534,8239,181428,17604,85.3,181,falling,61.3,127,201973,0,1
OH,"Clinton County, Ohio",6425,3000,3425,39027,46787,18135,2474,19000,1970,37135,4444,86.6,42,stable,68.2,33,41917,0,0
OH,"Columbiana County, Ohio",15730,6792,8938,39029,44497,44011,6434,46550,5526,90561,11960,68.6,101,stable,52.3,76,104806,0,0
OH,"Coshocton County, Ohio",5835,2516,3319,39031,41701,15556,2590,15536,2660,31092,5250,74,36,stable,64.6,31,36569,0,0
OH,"Crawford County, Ohio",6888,2976,3912,39033,40795,18546,2003,19625,2020,38171,4023,66.6,41,stable,54.4,33,42306,0,0
OH,"Cuyahoga County, Ohio",231823,101682,130141,39035,44190,526859,66437,601157,53215,1128016,119652,68.7,1108,falling,51.1,838,1255921,0,1
OH,"Darke County, Ohio",6846,3045,3801,39037,44632,22865,2645,24022,2213,46887,4858,65.9,46,stable,52.7,37,52076,0,0
OH,"Defiance County, Ohio",5071,2187,2884,39039,50663,16977,2192,17511,1679,34488,3871,67.3,32,stable,56.6,27,38352,0,0
OH,"Delaware County, Ohio",8285,3705,4580,39041,91955,86544,4668,89842,3441,176386,8109,61,94,stable,44.1,66,193013,0,0
OH,"Erie County, Ohio",9333,4116,5217,39043,48011,32644,4193,35368,3004,68012,7197,65,71,stable,54.4,59,75550,0,0
OH,"Fairfield County, Ohio",15110,6752,8358,39045,60567,66091,5886,69770,4743,135861,10629,73.6,117,falling,54.3,86,151408,0,1
OH,"Fayette County, Ohio",5185,2461,2724,39047,40503,12093,1818,12750,1609,24843,3427,87.4,32,stable,67.7,24,28679,0,0
OH,"Franklin County, Ohio",208422,95908,112514,39049,52341,511117,77423,557121,62162,1068238,139585,70.3,736,stable,53.5,553,1251722,0,0
OH,"Fulton County, Ohio",4532,2197,2335,39051,55120,19523,1367,20214,999,39737,2366,48.4,25,falling,45.3,24,42537,0,1
OH,"Gallia County, Ohio",6214,2541,3673,39053,37319,12476,2209,13705,1756,26181,3965,88.7,35,stable,67.2,26,30142,0,0
OH,"Geauga County, Ohio",6969,3258,3711,39055,72430,40116,5896,42688,4557,82804,10453,51.4,63,stable,35.2,43,94102,0,0
OH,"Greene County, Ohio",21065,9574,11491,39057,60113,71331,6600,77789,4516,149120,11116,60.9,113,stable,43.5,81,164427,0,0
OH,"Guernsey County, Ohio",7784,3427,4357,39059,40930,16774,2444,18074,1851,34848,4295,82.2,43,stable,70.6,37,39258,0,0
OH,"Hamilton County, Ohio",143778,63809,79969,39061,49013,339523,43509,380210,32950,719733,76459,75.1,673,stable,55.7,500,807598,0,0
OH,"Hancock County, Ohio",10221,4369,5852,39063,50895,33307,3300,35026,2975,68333,6275,57.9,52,stable,48.4,44,75573,0,0
OH,"Hardin County, Ohio",5491,2667,2824,39065,42703,13877,1873,13905,1877,27782,3750,72.9,26,stable,57.9,21,31682,0,0
OH,"Harrison County, Ohio",2657,1186,1471,39067,43173,6814,776,6933,858,13747,1634,72.7,17,stable,57.6,14,15450,0,0
OH,"Henry County, Ohio",3144,1325,1819,39069,53835,12487,1198,13137,831,25624,2029,55.3,20,stable,48.2,18,27816,0,0
OH,"Highland County, Ohio",8604,3780,4824,39071,39858,18337,2813,18763,2841,37100,5654,75.8,41,stable,66.7,36,43026,0,0
OH,"Hocking County, Ohio",4894,2116,2778,39073,42170,12117,1860,12703,1551,24820,3411,75.9,28,stable,66.3,25,28491,0,0
OH,"Holmes County, Ohio",5398,2451,2947,39075,51996,12699,8654,12058,9249,24757,17903,40,16,stable,26.3,11,43909,0,0
OH,"Huron County, Ohio",7853,3501,4352,39077,48745,25591,3298,27087,2445,52678,5743,78.2,54,stable,63.3,43,58469,0,0
OH,"Jackson County, Ohio",7637,3320,4317,39079,39460,13973,1942,14869,1741,28842,3683,82.3,33,stable,66.2,27,32596,0,0
OH,"Jefferson County, Ohio",11533,4875,6658,39081,41942,29123,3514,31757,2923,60880,6437,78.6,78,stable,58.7,59,67347,0,0
OH,"Knox County, Ohio",8825,3995,4830,39083,48533,25850,3783,27262,3531,53112,7314,69.8,51,stable,48,35,61061,0,0
OH,"Lake County, Ohio",20063,8926,11137,39085,58029,101515,9739,107925,8200,209440,17939,73,222,stable,55.4,169,229245,0,0
OH,"Lawrence County, Ohio",11135,5080,6055,39087,42874,26399,3593,28448,2803,54847,6396,83.4,66,stable,67.8,53,61109,0,0
OH,"Licking County, Ohio",20926,9134,11792,39089,56549,74195,7804,77981,7386,152176,15190,78.5,149,falling,60.1,113,170570,0,1
OH,"Logan County, Ohio",6487,2767,3720,39091,49783,19176,3129,20589,2276,39765,5405,70.7,40,stable,60,34,45386,0,0
OH,"Lorain County, Ohio",42269,17426,24843,39093,52457,130768,13366,141653,10783,272421,24149,71,259,stable,55.1,200,305147,0,0
OH,"Lucas County, Ohio",90091,42034,48057,39095,41777,183219,25409,203622,18716,386841,44125,61.9,306,stable,55.4,275,433689,0,0
OH,"Madison County, Ohio",3580,1621,1959,39097,57406,16709,2312,18209,1293,34918,3605,74.8,36,stable,52.8,25,44094,0,0
OH,"Mahoning County, Ohio",40841,17922,22919,39099,41375,98779,11550,109376,9338,208155,20888,69.4,232,stable,53.4,183,231900,0,0
OH,"Marion County, Ohio",11127,4978,6149,39101,42966,25849,3294,27630,3027,53479,6321,82.9,67,falling,62.2,51,65355,0,1
OH,"Medina County, Ohio",12859,5798,7061,39103,66952,79425,6220,82372,5707,161797,11927,62.1,123,stable,45.9,90,176395,0,0
OH,"Meigs County, Ohio",5285,2498,2787,39105,37813,9951,1527,10483,1304,20434,2831,71.8,22,stable,51.7,16,23257,0,0
OH,"Mercer County, Ohio",3399,1428,1971,39107,53099,18786,1591,18863,1252,37649,2843,52.9,28,stable,39.8,21,40968,0,0
OH,"Miami County, Ohio",13076,5466,7610,39109,51569,45696,4834,48031,4148,93727,8982,73.7,95,falling,54.9,72,104224,0,1
OH,"Monroe County, Ohio",2782,1268,1514,39111,41528,6389,842,6423,747,12812,1589,60.3,13,stable,54.6,12,14409,0,0
OH,"Montgomery County, Ohio",96354,42909,53445,39113,43829,221306,31005,249399,23700,470705,54705,76.4,507,stable,56.3,376,532258,0,0
OH,"Morgan County, Ohio",3111,1481,1630,39115,37067,6195,1159,6417,954,12612,2113,80.5,18,stable,64.8,14,14777,0,0
OH,"Morrow County, Ohio",4063,2119,1944,39117,51993,15638,1728,15715,1616,31353,3344,80.1,34,stable,54.2,22,35074,0,0
OH,"Muskingum County, Ohio",15554,7155,8399,39119,41130,36412,4893,39884,3967,76296,8860,80.6,87,stable,69.6,75,86290,0,0
OH,"Noble County, Ohio",1521,670,851,39121,41708,5243,646,5432,657,10675,1303,48.6,12,stable,37.5,9,14326,0,0
OH,"Ottawa County, Ohio",4349,1803,2546,39123,53914,18685,1501,19028,1519,37713,3020,66,43,stable,55.7,35,40877,0,0
OH,"Paulding County, Ohio",2436,1188,1248,39125,45550,8635,838,8773,817,17408,1655,87.6,21,stable,68.9,17,18976,0,0
OH,"Perry County, Ohio",6876,2994,3882,39127,42017,16107,1826,15993,1823,32100,3649,78.5,33,stable,63.3,26,35985,0,0
OH,"Pickaway County, Ohio",6509,3040,3469,39129,57439,23689,2254,24408,2016,48097,4270,77.5,49,stable,64.6,41,56998,0,0
OH,"Pike County, Ohio",6436,3038,3398,39131,40283,11707,2310,12640,1357,24347,3667,91.3,33,stable,67.8,24,28217,0,0
OH,"Portage County, Ohio",24219,10238,13981,39133,52552,71543,7060,75801,6452,147344,13512,72.1,128,stable,56.7,100,162275,0,0
OH,"Preble County, Ohio",5477,2504,2973,39135,47818,18511,2018,18795,2029,37306,4047,72.2,39,stable,57.7,31,41329,0,0
OH,"Putnam County, Ohio",1966,831,1135,39137,60524,16179,831,16121,790,32300,1621,45.5,19,stable,36.7,15,34042,0,0
OH,"Richland County, Ohio",19504,8622,10882,39139,41877,49703,6482,53371,6270,103074,12752,71.5,118,falling,56.2,93,121707,0,1
OH,"Ross County, Ohio",13746,6062,7684,39141,43345,31008,4216,33149,3191,64157,7407,85.2,79,stable,63.9,58,77170,0,0
OH,"Sandusky County, Ohio",8458,3644,4814,39143,47209,26820,2648,27470,2397,54290,5045,69.2,53,stable,56.2,43,59679,0,0
OH,"Scioto County, Ohio",18740,8702,10038,39145,35903,31964,4628,34529,4037,66493,8665,97.8,96,stable,73.2,71,76825,0,0
OH,"Seneca County, Ohio",8923,4164,4759,39147,45444,25100,2377,25497,1961,50597,4338,72.1,49,stable,54,38,55610,0,0
OH,"Shelby County, Ohio",4970,2048,2922,39149,54550,22360,2057,22913,1377,45273,3434,55.7,32,stable,44.2,24,48901,0,0
OH,"Stark County, Ohio",53715,23898,29817,39151,47137,161717,18295,175145,15018,336862,33313,68.1,338,stable,51.9,258,375165,0,0
OH,"Summit County, Ohio",78658,35036,43622,39153,50765,232858,27322,255090,21505,487948,48827,67.2,449,falling,52.3,352,541968,0,1
OH,"Trumbull County, Ohio",34912,15220,19692,39155,43073,85163,12942,94128,10463,179291,23405,80.8,237,stable,56.5,168,203751,0,0
OH,"Tuscarawas County, Ohio",12763,5748,7015,39157,45310,39847,5517,41619,4711,81466,10228,61,76,stable,45.3,56,92916,0,0
OH,"Union County, Ohio",4344,1959,2385,39159,67382,23304,1945,23504,1475,46808,3420,68.9,33,stable,54.5,26,54277,0,0
OH,"Van Wert County, Ohio",3600,1623,1977,39161,48060,12572,1307,13315,1101,25887,2408,56.2,21,stable,47.1,18,28562,0,0
OH,"Vinton County, Ohio",2713,1100,1613,39163,40680,5730,896,5921,614,11651,1510,114.2,19,stable,64.5,11,13048,0,0
OH,"Warren County, Ohio",11885,4930,6955,39165,74379,98462,6599,103216,5654,201678,12253,65.8,139,stable,49.4,102,224469,0,0
OH,"Washington County, Ohio",9777,4438,5339,39167,43509,26597,3277,28123,2685,54720,5962,75.8,67,stable,55.5,49,61112,0,0
OH,"Wayne County, Ohio",14758,6498,8260,39169,50383,48314,8351,49904,7723,98218,16074,57,79,stable,44.3,62,116063,0,0
OH,"Williams County, Ohio",5386,2265,3121,39171,42492,16155,1681,17156,1254,33311,2935,66,32,stable,48.2,23,37120,0,0
OH,"Wood County, Ohio",17461,8079,9382,39173,53577,58179,4587,61220,3660,119399,8247,53.3,73,stable,45,61,129730,0,0
OH,"Wyandot County, Ohio",2601,1060,1541,39175,47555,9865,1105,10393,840,20258,1945,74.4,22,stable,56.3,17,22243,0,0
OK,"Adair County, Oklahoma",5897,2813,3084,40001,33404,7818,3227,8131,2961,15949,6188,71.5,18,stable,52.7,13,22004,0,0
OK,"Alfalfa County, Oklahoma",606,319,287,40003,50156,2091,355,1982,294,4073,649,61.2,5,stable,53,5,5868,0,0
OK,"Atoka County, Oklahoma",2794,1204,1590,40005,36661,4620,1271,5148,1433,9768,2704,80.2,14,stable,49.9,9,13793,0,0
OK,"Beckham County, Oklahoma",2777,1101,1676,40009,48601,9006,1957,8870,1800,17876,3757,53.8,13,stable,44.7,10,23768,0,0
OK,"Blaine County, Oklahoma",1293,524,769,40011,41972,3144,469,3941,527,7085,996,66.4,9,stable,48.6,7,9833,0,0
OK,"Bryan County, Oklahoma",7816,3424,4392,40013,38847,16794,4402,18231,4136,35025,8538,87.9,48,stable,74,41,44884,0,0
OK,"Caddo County, Oklahoma",5976,2901,3075,40015,40674,10739,3495,10819,3197,21558,6692,85.3,30,stable,65.4,23,29343,0,0
OK,"Canadian County, Oklahoma",8995,3890,5105,40017,64505,54096,6921,57233,6067,111329,12988,70.2,80,stable,49.7,56,133378,0,0
OK,"Carter County, Oklahoma",7262,3135,4127,40019,44531,18995,4017,20961,3842,39956,7859,77.6,45,stable,64,38,48689,0,0
OK,"Cherokee County, Oklahoma",10426,5020,5406,40021,38694,18034,5459,18325,5702,36359,11161,79.3,41,stable,66.4,34,48447,0,0
OK,"Choctaw County, Oklahoma",4297,1952,2345,40023,30617,5331,1895,5919,1797,11250,3692,80.4,17,stable,70.6,15,14997,0,0
OK,"Cleveland County, Oklahoma",32758,15142,17616,40027,56452,113205,16326,119149,14496,232354,30822,66.3,156,falling,49.7,116,274458,0,1
OK,"Coal County, Oklahoma",1186,515,671,40029,38243,2095,743,2242,666,4337,1409,85.8,7,stable,81.1,7,5651,0,0
OK,"Comanche County, Oklahoma",20444,8810,11634,40031,46241,44938,8863,50108,8306,95046,17169,72.8,80,stable,58.2,63,124648,0,0
OK,"Cotton County, Oklahoma",1030,467,563,40033,46361,2377,585,2497,531,4874,1116,59.8,5,stable,63.5,5,5996,0,0
OK,"Craig County, Oklahoma",2659,1162,1497,40035,38876,5675,1233,5666,1430,11341,2663,85.9,18,stable,76.6,16,14818,0,0
OK,"Creek County, Oklahoma",10813,4877,5936,40037,45016,28847,5822,29842,5449,58689,11271,87.7,78,stable,67.1,60,70892,0,0
OK,"Custer County, Oklahoma",4595,2089,2506,40039,46125,11710,2539,11990,2291,23700,4830,71.5,21,stable,60.2,18,29744,0,0
OK,"Delaware County, Oklahoma",8311,3830,4481,40041,37942,16145,4162,16743,3980,32888,8142,71.3,46,stable,57.8,37,41459,0,0
OK,"Dewey County, Oklahoma",788,367,421,40043,50904,2008,415,2034,302,4042,717,48.3,4,stable,56.5,4,4995,0,0
OK,"Ellis County, Oklahoma",595,291,304,40045,50855,1793,244,1874,184,3667,428,65.8,4,stable,50,3,4231,0,0
OK,"Garfield County, Oklahoma",7852,3563,4289,40047,48238,24926,4571,26885,3714,51811,8285,62.4,46,stable,51.8,39,63569,0,0
OK,"Garvin County, Oklahoma",5038,2280,2758,40049,40524,11088,2352,11481,2294,22569,4646,87.9,32,stable,72.2,26,27755,0,0
OK,"Grady County, Oklahoma",6690,2780,3910,40051,52279,22055,4218,22808,3956,44863,8174,67.6,41,stable,56.7,35,54648,0,0
OK,"Grant County, Oklahoma",430,156,274,40053,50250,2010,177,1982,270,3992,447,60.2,4,stable,64,5,4523,0,0
OK,"Greer County, Oklahoma",735,346,389,40055,40125,2078,458,2015,490,4093,948,89.8,7,stable,65,5,6070,0,0
OK,"Haskell County, Oklahoma",2524,1126,1398,40061,35252,4857,1485,4929,1510,9786,2995,75.8,13,stable,69.9,12,12845,0,0
OK,"Hughes County, Oklahoma",2244,1025,1219,40063,35563,4591,1275,4939,1300,9530,2575,88.5,17,stable,77.6,15,13735,0,0
OK,"Jackson County, Oklahoma",4276,1665,2611,40065,41560,9811,1887,10682,2080,20493,3967,58.6,17,stable,58.6,17,25574,0,0
OK,"Jefferson County, Oklahoma",1313,607,706,40067,33449,2425,695,2433,636,4858,1331,79,7,stable,64.3,6,6276,0,0
OK,"Johnston County, Oklahoma",2070,777,1293,40069,38776,4257,1055,4298,1292,8555,2347,54.9,8,stable,60,9,10980,0,0
OK,"Kay County, Oklahoma",8137,3467,4670,40071,42134,18064,4099,19228,3530,37292,7629,72.9,45,stable,64.7,40,45366,0,0
OK,"Kingfisher County, Oklahoma",1093,481,612,40073,60034,6676,903,6395,1169,13071,2072,70.4,13,stable,54.5,10,15584,0,0
OK,"Kiowa County, Oklahoma",1883,806,1077,40075,39909,3787,676,3804,836,7591,1512,75.1,10,stable,66.1,9,9144,0,0
OK,"Latimer County, Oklahoma",1833,776,1057,40077,39205,4119,1194,4221,1032,8340,2226,59.9,9,stable,56.4,9,10483,0,0
OK,"Le Flore County, Oklahoma",11035,4903,6132,40079,36490,18447,5735,19478,5085,37925,10820,62.2,38,stable,75.4,47,49605,0,0
OK,"Lincoln County, Oklahoma",5335,2418,2917,40081,45149,14153,2800,14337,2813,28490,5613,66.3,30,stable,66.4,29,35042,0,0
OK,"Logan County, Oklahoma",4943,2388,2555,40083,55299,18313,3563,19275,2987,37588,6550,67.4,32,stable,50.3,24,45996,0,0
OK,"Love County, Oklahoma",1292,604,688,40085,44549,3860,847,4177,694,8037,1541,57.5,7,stable,48.4,6,9870,0,0
OK,"McClain County, Oklahoma",3944,1922,2022,40087,56088,15556,2496,15845,2338,31401,4834,83,32,stable,60.1,23,38066,0,0
OK,"McCurtain County, Oklahoma",8256,3703,4553,40089,32324,12335,3672,12912,3806,25247,7478,94.2,39,stable,65.6,27,33048,0,0
OK,"McIntosh County, Oklahoma",4209,1975,2234,40091,36011,7958,1904,8188,1922,16146,3826,76.9,26,stable,70.1,24,19990,0,0
OK,"Major County, Oklahoma",1073,456,617,40093,51571,3355,473,3344,464,6699,937,59.3,6,stable,42.7,5,7771,0,0
OK,"Marshall County, Oklahoma",2645,1134,1511,40095,40475,6309,1554,6322,1597,12631,3151,71.7,18,stable,61.9,15,16232,0,0
OK,"Mayes County, Oklahoma",8585,3814,4771,40097,42071,15800,4325,16888,3557,32688,7882,84.2,44,stable,63.9,33,40887,0,0
OK,"Murray County, Oklahoma",2012,764,1248,40099,47077,5264,1276,5525,1259,10789,2535,97.5,18,stable,66.9,13,13936,0,0
OK,"Muskogee County, Oklahoma",14670,6326,8344,40101,39984,25770,6904,27841,6878,53611,13782,97.9,84,stable,74,63,69699,0,0
OK,"Noble County, Oklahoma",1515,695,820,40103,48285,4961,617,5314,514,10275,1131,59.7,9,stable,48.7,8,11554,0,0
OK,"Nowata County, Oklahoma",1928,881,1047,40105,39875,4128,968,4379,876,8507,1844,59.7,9,stable,54.9,8,10539,0,0
OK,"Okfuskee County, Oklahoma",2797,1344,1453,40107,36216,4562,1234,4333,1219,8895,2453,65.3,11,stable,64.6,10,12181,0,0
OK,"Oklahoma County, Oklahoma",134377,59501,74876,40109,47437,290614,69706,319677,62086,610291,131792,69.5,513,stable,55.9,409,776864,0,0
OK,"Okmulgee County, Oklahoma",7880,3555,4325,40111,38843,15883,3339,16422,3157,32305,6496,95.2,48,stable,71.9,36,39187,0,0
OK,"Osage County, Oklahoma",7365,3002,4363,40113,45443,19240,3500,20344,3542,39584,7042,55.9,36,stable,56,36,47887,0,0
OK,"Ottawa County, Oklahoma",7112,3361,3751,40115,36347,12486,3031,13216,2909,25702,5940,80.2,34,stable,74,32,31981,0,0
OK,"Pawnee County, Oklahoma",2249,980,1269,40117,45765,6814,1378,6761,1390,13575,2768,77.7,18,stable,58.3,13,16436,0,0
OK,"Payne County, Oklahoma",18483,9075,9408,40119,37667,33802,5931,33833,4760,67635,10691,62,42,stable,51.8,35,80850,0,0
OK,"Pittsburg County, Oklahoma",7994,3657,4337,40121,42576,17011,4194,17701,4141,34712,8335,76.3,47,falling,65.9,41,44610,0,1
OK,"Pontotoc County, Oklahoma",6769,3222,3547,40123,43261,14501,3790,15928,3381,30429,7171,73.3,33,stable,60.1,27,38194,0,0
OK,"Pottawatomie County, Oklahoma",12288,5580,6708,40125,44688,27591,5917,29672,5679,57263,11596,85.4,70,stable,60.9,49,71875,0,0
OK,"Pushmataha County, Oklahoma",2716,1195,1521,40127,32445,4053,1387,4462,1195,8515,2582,65.2,11,stable,81.6,14,11183,0,0
OK,"Rogers County, Oklahoma",8271,3365,4906,40131,58139,38004,5648,39145,5424,77149,11072,62.8,64,stable,49.2,49,90802,0,0
OK,"Seminole County, Oklahoma",5371,2334,3037,40133,36068,9442,2759,10115,2725,19557,5484,85.9,29,stable,72.4,24,25548,0,0
OK,"Sequoyah County, Oklahoma",10261,5048,5213,40135,35736,15333,4912,16477,4370,31810,9282,71.1,38,stable,70.4,37,41153,0,0
OK,"Stephens County, Oklahoma",6740,2876,3864,40137,43781,18163,3303,19398,3340,37561,6643,69.2,42,stable,54.4,33,44581,0,0
OK,"Texas County, Oklahoma",2733,1158,1575,40139,50242,8757,2504,8372,1825,17129,4329,51.3,9,stable,39.9,7,21489,0,0
OK,"Tillman County, Oklahoma",1750,848,902,40141,37759,2957,668,3127,598,6084,1266,59.7,6,stable,35.7,4,7515,0,0
OK,"Tulsa County, Oklahoma",96498,42178,54320,40143,49759,247089,54017,268472,48606,515561,102623,67.1,421,stable,52.6,328,639242,0,0
OK,"Wagoner County, Oklahoma",8150,3605,4545,40145,55715,31523,5502,33066,4991,64589,10493,68.8,56,stable,55.3,43,76559,0,0
OK,"Washington County, Oklahoma",7307,3205,4102,40147,50023,20860,3976,22595,3927,43455,7903,78.6,56,stable,58.7,42,52021,0,0
OK,"Washita County, Oklahoma",1725,666,1059,40149,49632,5025,707,5024,670,10049,1377,52.9,8,falling,51.3,8,11661,0,1
OK,"Woods County, Oklahoma",1283,662,621,40151,55315,3677,585,3657,402,7334,987,55.5,6,stable,45.1,5,9304,0,0
OK,"Woodward County, Oklahoma",2595,1056,1539,40153,55300,9307,902,8779,978,18086,1880,41,10,stable,37.1,9,21559,0,0
OR,"Baker County, Oregon",2353,1144,1209,41001,41098,6847,845,6962,883,13809,1728,65,18,stable,50.4,14,16005,0,0
OR,"Benton County, Oregon",18139,9502,8637,41003,49802,39465,3980,39520,3280,78985,7260,48.9,43,stable,39.2,35,87572,0,0
OR,"Clackamas County, Oregon",36894,16509,20385,41005,65965,171023,19794,179518,17540,350541,37334,55.2,245,stable,43.2,189,401515,0,0
OR,"Clatsop County, Oregon",5791,2590,3201,41007,46408,15177,2761,16376,2292,31553,5053,72.4,37,stable,52.2,27,37831,0,0
OR,"Columbia County, Oregon",6638,3004,3634,41009,53179,21777,2706,22015,2569,43792,5275,63.2,38,stable,54.4,32,49600,0,0
OR,"Coos County, Oregon",11310,5154,6156,41011,38605,25506,4579,27783,3960,53289,8539,73.5,78,stable,64.2,69,63121,0,0
OR,"Crook County, Oregon",4048,1787,2261,41013,37106,9015,1309,9178,1372,18193,2681,54,19,stable,41.6,14,21630,0,0
OR,"Curry County, Oregon",3682,1519,2163,41015,40884,9356,1432,10131,1275,19487,2707,61.9,29,stable,50.8,24,22483,0,0
OR,"Deschutes County, Oregon",24220,11509,12711,41017,51223,69387,12338,72618,11600,142005,23938,53.1,105,stable,37.7,74,175268,0,0
OR,"Douglas County, Oregon",20377,8874,11503,41019,41312,45725,6764,48143,5915,93868,12679,67,118,falling,59.7,107,107685,0,1
OR,"Grant County, Oregon",1138,508,630,41023,38046,3005,487,3207,443,6212,930,41.9,6,stable,29.8,4,7185,0,0
OR,"Harney County, Oregon",1268,573,695,41025,37580,3115,433,3168,407,6283,840,43.9,5,stable,43.3,5,7200,0,0
OR,"Hood River County, Oregon",3223,1435,1788,41027,55827,9311,1994,9671,1692,18982,3686,45.6,11,stable,40.9,10,23137,0,0
OR,"Jackson County, Oregon",39122,18447,20675,41029,44028,84534,16280,92282,14188,176816,30468,62.6,184,stable,45.6,134,212567,0,0
OR,"Jefferson County, Oregon",4358,2092,2266,41031,46366,8583,2016,8962,1739,17545,3755,50.9,14,stable,43.2,11,22666,0,0
OR,"Josephine County, Oregon",16627,8447,8180,41033,37665,34548,5828,37702,4663,72250,10491,72.1,104,stable,56.9,83,84745,0,0
OR,"Klamath County, Oregon",12542,5452,7090,41035,40336,28026,4452,28850,4124,56876,8576,60.3,56,stable,47.7,44,66016,0,0
OR,"Lake County, Oregon",1365,663,702,41037,32369,3203,540,3147,471,6350,1011,47,6,stable,33.3,4,7829,0,0
OR,"Lane County, Oregon",70308,34709,35599,41039,44103,150317,24192,161782,19249,312099,43441,53.9,237,stable,45.3,200,362895,0,0
OR,"Lincoln County, Oregon",7754,3580,4174,41041,42101,18568,3765,20081,3652,38649,7417,74.4,60,stable,58.9,47,47038,0,0
OR,"Linn County, Oregon",22201,9995,12206,41043,45644,50776,7628,53255,6574,104031,14202,71.3,106,stable,53.4,79,120547,0,0
OR,"Malheur County, Oregon",6865,2879,3986,41045,35418,11227,2206,11663,2105,22890,4311,54,20,stable,41.5,15,30380,0,0
OR,"Marion County, Oregon",57846,26573,31273,41047,48432,131443,24315,141525,20041,272968,44356,66.1,227,stable,45.9,157,330700,0,0
OR,"Morrow County, Oregon",1844,862,982,41049,50918,5057,741,4632,766,9689,1507,62.3,8,stable,53.5,7,11190,0,0
OR,"Multnomah County, Oregon",136472,64213,72259,41051,54102,323119,53210,345432,41447,668551,94657,62.2,432,stable,47.5,327,790294,0,0
OR,"Polk County, Oregon",12270,5616,6654,41053,52821,32708,4268,36242,3666,68950,7934,52.1,48,stable,38.3,36,79391,0,0
OR,"Tillamook County, Oregon",4310,2086,2224,41057,42581,10705,1559,10946,1557,21651,3116,63.6,27,stable,44,19,25653,0,0
OR,"Umatilla County, Oregon",12733,5516,7217,41059,48101,30466,5561,31784,4760,62250,10321,58,48,stable,45.1,37,76531,0,0
OR,"Union County, Oregon",4641,1955,2686,41061,43822,10846,1648,11547,1416,22393,3064,44.7,15,falling,41.7,15,25790,0,1
OR,"Wallowa County, Oregon",1033,492,541,41063,40581,2903,428,3121,311,6024,739,46.3,6,stable,35.5,4,6856,0,0
OR,"Wasco County, Oregon",4015,1812,2203,41065,43422,10397,1964,11059,1641,21456,3605,74.1,26,stable,51.7,18,25775,0,0
OR,"Washington County, Oregon",64861,29554,35307,41067,66754,238347,34065,251792,28520,490139,62585,48,231,stable,35.1,167,574326,0,0
OR,"Yamhill County, Oregon",15877,7131,8746,41071,53423,42081,6619,45550,4735,87631,11354,65.2,73,stable,44.7,50,102659,0,0
PA,"Adams County, Pennsylvania",8715,3721,4994,42001,60356,45267,4419,46924,3839,92191,8258,59.2,79,stable,41.5,55,102295,0,0
PA,"Allegheny County, Pennsylvania",155874,67353,88521,42003,53040,536490,48058,596998,35491,1133488,83549,72.5,1193,stable,51.3,862,1230459,0,0
PA,"Armstrong County, Pennsylvania",8738,3962,4776,42005,44942,30637,2828,31315,2661,61952,5489,66.4,67,stable,46.4,48,67052,0,0
PA,"Beaver County, Pennsylvania",19888,8582,11306,42007,50581,75565,5976,81562,5378,157127,11354,76.5,192,stable,49.7,129,168871,0,0
PA,"Bedford County, Pennsylvania",6643,2986,3657,42009,45930,21515,2699,21871,2457,43386,5156,51,37,stable,41.2,30,48586,0,0
PA,"Berks County, Pennsylvania",56855,25575,31280,42011,55936,179872,20953,191095,17231,370967,38184,64.1,316,rising,42.3,211,415271,1,0
PA,"Blair County, Pennsylvania",18548,8198,10350,42013,43981,55111,5728,59618,4406,114729,10134,66.3,119,stable,43.9,79,125593,0,0
PA,"Bradford County, Pennsylvania",8336,3681,4655,42015,48987,26927,3428,28330,2923,55257,6351,70.7,63,stable,50.2,45,61281,0,0
PA,"Bucks County, Pennsylvania",36868,15318,21550,42017,77568,283543,20263,300110,16531,583653,36794,62.5,487,stable,43.9,340,627367,0,0
PA,"Butler County, Pennsylvania",16325,7113,9212,42019,60934,84451,5945,88136,5118,172587,11063,61.4,143,stable,48.9,114,186818,0,0
PA,"Cambria County, Pennsylvania",20011,8513,11498,42021,42107,59888,5256,65635,4046,125523,9302,56.7,119,stable,43.7,95,136411,0,0
PA,"Carbon County, Pennsylvania",6909,2993,3916,42025,49973,28504,2939,29761,2620,58265,5559,72.7,68,stable,53.4,50,63960,0,0
PA,"Centre County, Pennsylvania",27217,14043,13174,42027,52186,73881,5854,70268,4384,144149,10238,53.1,77,stable,37.9,56,160580,0,0
PA,"Chester County, Pennsylvania",35053,15855,19198,42029,85976,226928,20920,240899,16180,467827,37100,54,301,stable,39.4,219,515939,0,0
PA,"Clarion County, Pennsylvania",6881,3045,3836,42031,42536,16960,2041,18309,1721,35269,3762,59.2,31,stable,45.1,23,39498,0,0
PA,"Clearfield County, Pennsylvania",11306,5035,6271,42033,42257,33960,3682,35154,3195,69114,6877,60.3,69,stable,45.6,53,80994,0,0
PA,"Clinton County, Pennsylvania",6086,2474,3612,42035,45078,16748,2119,18306,1834,35054,3953,67.7,34,stable,57.3,29,39441,0,0
PA,"Columbia County, Pennsylvania",10067,4475,5592,42037,45374,29360,2388,32437,1957,61797,4345,58,50,stable,43.7,38,66672,0,0
PA,"Crawford County, Pennsylvania",12321,5698,6623,42039,44579,36696,5586,38231,5244,74927,10830,67.5,81,stable,54,64,86484,0,0
PA,"Cumberland County, Pennsylvania",19984,8850,11134,42041,61820,105040,9174,113648,7226,218688,16400,56.8,172,stable,40,123,246338,0,0
PA,"Dauphin County, Pennsylvania",36269,16243,20026,42043,53754,115148,13772,127773,11033,242921,24805,66.7,210,stable,45.1,144,272983,0,0
PA,"Delaware County, Pennsylvania",57202,25013,32189,42045,65123,241202,23418,269945,19730,511147,43148,70.8,468,falling,52.7,350,563894,0,1
PA,"Elk County, Pennsylvania",2721,1090,1631,42047,46671,14208,1204,14844,791,29052,1995,65.8,32,stable,54.2,27,30872,0,0
PA,"Erie County, Pennsylvania",44595,19834,24761,42049,45971,121595,12453,131087,9475,252682,21928,66.5,225,stable,48.7,164,278045,0,0
PA,"Fayette County, Pennsylvania",25282,10838,14444,42051,39636,57134,6460,62630,5263,119764,11723,77.5,151,stable,59.9,119,133628,0,0
PA,"Forest County, Pennsylvania",523,245,278,42053,35533,1618,95,1800,156,3418,251,68.6,8,stable,68,8,7410,0,0
PA,"Franklin County, Pennsylvania",17554,7644,9910,42055,53916,63891,10065,68419,8597,132310,18662,58.5,116,stable,44.8,89,153638,0,0
PA,"Fulton County, Pennsylvania",1779,763,1016,42057,48311,6665,725,6698,562,13363,1287,54.3,11,stable,49.1,10,14629,0,0
PA,"Greene County, Pennsylvania",4672,1970,2702,42059,46661,14997,1423,16705,1409,31702,2832,84.2,42,stable,60,29,37519,0,0
PA,"Huntingdon County, Pennsylvania",5578,2342,3236,42061,44396,18556,2031,19914,1550,38470,3581,58.4,36,stable,45.7,29,45668,0,0
PA,"Indiana County, Pennsylvania",14176,6724,7452,42063,45195,37802,5238,38940,4362,76742,9600,52.9,59,stable,36.8,42,86966,0,0
PA,"Jefferson County, Pennsylvania",6414,2841,3573,42065,42903,19527,2451,19928,2305,39455,4756,66.1,43,stable,41.4,27,44430,0,0
PA,"Juniata County, Pennsylvania",3245,1410,1835,42067,47398,10386,1917,10615,1643,21001,3560,54.7,18,stable,43,14,24737,0,0
PA,"Lackawanna County, Pennsylvania",30447,13104,17343,42069,46271,91401,9669,101629,6991,193030,16660,70.4,208,stable,47.5,144,211917,0,0
PA,"Lancaster County, Pennsylvania",55372,25250,30122,42071,57721,221257,34798,235699,31456,456956,66254,53.3,340,stable,38.5,249,536624,0,0
PA,"Lawrence County, Pennsylvania",13192,5770,7422,42073,44571,38993,3672,41997,3459,80990,7131,71.3,95,stable,52.1,71,88082,0,0
PA,"Lebanon County, Pennsylvania",14922,6555,8367,42075,55499,57116,8512,61657,6814,118773,15326,65.3,120,stable,49.8,92,137067,0,0
PA,"Lehigh County, Pennsylvania",45488,19230,26258,42077,56117,151765,19454,165135,15567,316900,35021,63.6,271,stable,41,178,360685,0,0
PA,"Luzerne County, Pennsylvania",48822,21579,27243,42079,45897,137597,14632,148186,11958,285783,26590,68.7,308,stable,46.1,210,318449,0,0
PA,"Lycoming County, Pennsylvania",16150,7164,8986,42081,47313,51054,5422,52534,4512,103588,9934,67.1,101,stable,51,78,116048,0,0
PA,"McKean County, Pennsylvania",6830,3230,3600,42083,43965,18718,1718,18801,1542,37519,3260,68.1,39,stable,50.2,30,42412,0,0
PA,"Mercer County, Pennsylvania",14549,6345,8204,42085,44156,48461,5240,53276,4406,101737,9646,66.9,110,stable,50.6,86,114234,0,0
PA,"Mifflin County, Pennsylvania",7216,3249,3967,42087,41288,19174,3604,20046,3293,39220,6897,70.4,48,stable,52,36,46500,0,0
PA,"Monroe County, Pennsylvania",20702,9712,10990,42089,57365,71747,10430,76082,8624,147829,19054,72.5,139,stable,55,103,166397,0,0
PA,"Montgomery County, Pennsylvania",52330,22642,29688,42091,80675,361453,25180,392043,20908,753496,46088,56.8,569,stable,40.4,408,819264,0,0
PA,"Montour County, Pennsylvania",1749,722,1027,42093,54648,7936,723,8717,523,16653,1246,56.1,15,stable,32,8,18557,0,0
PA,"Northampton County, Pennsylvania",27294,11982,15312,42095,60972,132436,12987,141524,9699,273960,22686,64.7,249,stable,45.5,177,300813,0,0
PA,"Northumberland County, Pennsylvania",12279,5998,6281,42097,42406,39185,4548,41667,4065,80852,8613,66.3,91,stable,52.4,73,93246,0,0
PA,"Perry County, Pennsylvania",4217,1783,2434,42099,57177,19945,2762,20190,2275,40135,5037,71.8,41,stable,54.1,30,45685,0,0
PA,"Philadelphia County, Pennsylvania",399352,178789,220563,42101,38253,612194,114397,726984,87190,1339178,201587,81.5,1260,falling,58.3,903,1567442,0,1
PA,"Pike County, Pennsylvania",5532,2403,3129,42103,60180,25086,2848,25903,2381,50989,5229,64.5,52,stable,41.2,32,55949,0,0
PA,"Potter County, Pennsylvania",2570,1124,1446,42105,40654,7682,900,7666,898,15348,1798,79.8,22,stable,56.6,15,17093,0,0
PA,"Schuylkill County, Pennsylvania",18278,8099,10179,42107,45535,61870,6938,64964,5868,126834,12806,68.1,144,stable,52.8,114,144590,0,0
PA,"Snyder County, Pennsylvania",4077,1683,2394,42109,49917,16547,3112,17299,2766,33846,5878,50.4,25,stable,38.2,19,40444,0,0
PA,"Somerset County, Pennsylvania",9074,3689,5385,42111,44587,32134,3445,33368,2942,65502,6387,48.5,56,stable,37.1,43,75522,0,0
PA,"Sullivan County, Pennsylvania",802,459,343,42113,44189,2854,366,2758,213,5612,579,69.3,8,rising,45.9,6,6328,1,0
PA,"Susquehanna County, Pennsylvania",5455,2517,2938,42115,50477,18579,2615,18736,2134,37315,4749,53.6,35,stable,43.2,27,41666,0,0
PA,"Tioga County, Pennsylvania",5891,2553,3338,42117,46494,18480,2352,18945,2094,37425,4446,69.6,41,stable,44.5,27,41877,0,0
PA,"Union County, Pennsylvania",4554,1984,2570,42119,49803,17003,2494,17874,2024,34877,4518,57.6,30,stable,36.8,20,44954,0,0
PA,"Venango County, Pennsylvania",8123,3615,4508,42121,43644,23455,2613,25029,2049,48484,4662,74.7,60,stable,56.5,46,53119,0,0
PA,"Warren County, Pennsylvania",4891,2209,2682,42123,44020,18265,1861,18589,1539,36854,3400,59.9,38,stable,48.3,31,40396,0,0
PA,"Washington County, Pennsylvania",21074,9161,11913,42125,56450,93215,7837,99622,5900,192837,13737,68.2,201,stable,51.8,156,208261,0,0
PA,"Wayne County, Pennsylvania",6164,2836,3328,42127,49919,21793,2342,22210,1717,44003,4059,64.4,51,stable,48.3,39,51198,0,0
PA,"Westmoreland County, Pennsylvania",36758,15792,20966,42129,52247,161502,12108,173372,9949,334874,22057,70.5,387,stable,48.5,271,357956,0,0
PA,"Wyoming County, Pennsylvania",3030,1313,1717,42131,51004,12674,1311,12815,1103,25489,2414,77.1,29,stable,51.5,20,27800,0,0
PA,"York County, Pennsylvania",46124,19823,26301,42133,58269,193984,20254,205039,15547,399023,35801,67.2,353,stable,46,240,442867,0,0
RI,"Bristol County, Rhode Island",3396,1458,1938,44001,72458,21668,1527,23909,1403,45577,2930,54.5,37,stable,38.8,27,49084,0,0
RI,"Kent County, Rhode Island",13763,5821,7942,44003,64383,73271,5936,79937,4404,153208,10340,68.9,150,stable,52.6,116,164801,0,0
RI,"Newport County, Rhode Island",8005,3159,4846,44005,69526,34929,3532,38696,2747,73625,6279,60.1,70,stable,42.2,50,82423,0,0
RI,"Providence County, Rhode Island",107120,47085,60035,44007,49743,259880,39761,291105,29863,550985,69624,72.7,503,stable,50.8,356,633473,0,0
RI,"Washington County, Rhode Island",11939,5494,6445,44009,72807,56838,3949,61538,3037,118376,6986,64.8,104,stable,45.9,74,126517,0,0
SC,"Abbeville County, South Carolina",5471,2510,2961,45001,34799,10557,1616,11107,1521,21664,3137,68.1,24,rising,57.6,20,24932,1,0
SC,"Aiken County, South Carolina",29126,13078,16048,45003,45759,66457,11763,73660,10259,140117,22022,58.5,122,falling,44,91,165829,0,1
SC,"Allendale County, South Carolina",2537,1164,1373,45005,25327,3288,870,3874,725,7162,1595,61.7,8,stable,50.1,6,9433,0,0
SC,"Anderson County, South Carolina",30915,13201,17714,45007,42143,77981,13678,84828,13434,162809,27112,69.6,166,stable,52.5,124,194692,0,0
SC,"Bamberg County, South Carolina",4077,2090,1987,45009,31314,5833,1422,6560,1456,12393,2878,59,13,stable,54.5,11,14880,0,0
SC,"Barnwell County, South Carolina",5819,2287,3532,45011,34336,8393,1764,10059,1590,18452,3354,59.5,15,stable,56.2,15,21725,0,0
SC,"Beaufort County, South Carolina",21221,9021,12200,45013,57048,65203,13044,74251,11394,139454,24438,49,124,stable,39,96,179589,0,0
SC,"Berkeley County, South Carolina",26327,11742,14585,45015,52506,76790,14687,82601,13959,159391,28646,84.8,142,stable,59.7,97,202786,0,0
SC,"Calhoun County, South Carolina",2896,1389,1507,45017,43531,5943,1245,6540,1110,12483,2355,59.7,12,stable,40,8,14781,0,0
SC,"Charleston County, South Carolina",62119,26269,35850,45019,53437,147518,27588,165993,24784,313511,52372,65.5,257,stable,45.7,177,389262,0,0
SC,"Cherokee County, South Carolina",13093,5591,7502,45021,35389,22852,4085,24214,4363,47066,8448,87.7,56,stable,57.9,38,56194,0,0
SC,"Chester County, South Carolina",8734,3931,4803,45023,31914,13333,2418,14555,2043,27888,4461,77.4,32,stable,61.8,25,32267,0,0
SC,"Chesterfield County, South Carolina",11930,6027,5903,45025,32083,18061,4230,20021,3415,38082,7645,81.2,45,stable,69.2,37,46017,0,0
SC,"Clarendon County, South Carolina",8163,3623,4540,45027,33162,12476,2754,14807,2550,27283,5304,70,35,stable,55.4,27,33775,0,0
SC,"Colleton County, South Carolina",8340,3466,4874,45029,32804,13977,3684,16615,3138,30592,6822,93.5,48,stable,73.9,38,37731,0,0
SC,"Darlington County, South Carolina",15878,6580,9298,45031,35409,26494,5130,30063,5479,56557,10609,72.4,62,stable,56.2,49,67548,0,0
SC,"Dillon County, South Carolina",10502,4356,6146,45033,28938,11823,2818,13869,2550,25692,5368,85.5,32,stable,73.6,27,31234,0,0
SC,"Dorchester County, South Carolina",18737,7557,11180,45035,54901,58873,9427,65555,8997,124428,18424,70.6,89,stable,50.5,61,152478,0,0
SC,"Edgefield County, South Carolina",3896,1597,2299,45037,46637,10071,1561,10803,1356,20874,2917,58.5,18,falling,40.1,11,26514,0,1
SC,"Fairfield County, South Carolina",5566,2255,3311,45039,36004,8822,2045,10276,1634,19098,3679,57.9,18,stable,50.7,16,22747,0,0
SC,"Florence County, South Carolina",26802,11243,15559,45041,42080,54653,9130,64203,8756,118856,17886,72.8,115,stable,56.3,87,138900,0,0
SC,"Georgetown County, South Carolina",12557,5083,7474,45043,42835,23043,5322,25907,5666,48950,10988,59.2,57,falling,54.4,51,61298,0,1
SC,"Greenville County, South Carolina",72169,31335,40834,45045,50540,191418,36038,210433,32540,401851,68578,64.6,324,stable,48.8,241,491863,0,0
SC,"Greenwood County, South Carolina",15875,6825,9050,45047,37060,26455,5937,30943,5161,57398,11098,63.2,54,stable,50.4,43,69838,0,0
SC,"Hampton County, South Carolina",3963,1734,2229,45049,31410,7981,1277,8585,1251,16566,2528,78.1,20,stable,54.2,14,20049,0,0
SC,"Horry County, South Carolina",51988,23286,28702,45051,43299,110502,30159,122928,25877,233430,56036,74.7,286,falling,58.5,219,309199,0,1
SC,"Jasper County, South Carolina",6106,2888,3218,45053,37141,9645,3107,10827,2293,20472,5400,51.9,14,stable,41.3,11,27824,0,0
SC,"Kershaw County, South Carolina",10467,4672,5795,45055,43622,25576,4545,27680,4370,53256,8915,73.6,57,stable,58.6,46,63603,0,0
SC,"Lancaster County, South Carolina",14802,6340,8462,45057,44016,31574,6691,35660,5498,67234,12189,67.5,68,stable,52.1,51,85842,0,0
SC,"Laurens County, South Carolina",13395,5938,7457,45059,38515,26436,5237,28520,5001,54956,10238,80.2,67,stable,61.6,52,66623,0,0
SC,"Lee County, South Carolina",4663,2202,2461,45061,30954,6869,1249,7676,1059,14545,2308,73,17,stable,63,14,17896,0,0
SC,"Lexington County, South Carolina",38470,16614,21856,45063,53857,113462,18221,123168,15916,236630,34137,68.5,196,stable,49.4,139,281833,0,0
SC,"McCormick County, South Carolina",1681,741,940,45065,38712,3739,490,4037,355,7776,845,67.4,13,stable,41.8,8,9706,0,0
SC,"Marion County, South Carolina",8865,3480,5385,45067,29874,11895,2774,14719,2576,26614,5350,79.3,33,stable,62.1,25,31747,0,0
SC,"Marlboro County, South Carolina",7224,3108,4116,45069,30767,9909,2000,11330,1652,21239,3652,87.2,29,stable,70.7,23,27494,0,0
SC,"Newberry County, South Carolina",6436,2717,3719,45071,40127,15554,2451,17302,1876,32856,4327,58.5,29,stable,52.9,26,38012,0,0
SC,"Oconee County, South Carolina",14897,6520,8377,45073,41237,30610,5988,32900,4886,63510,10874,68.8,75,stable,55.1,59,75713,0,0
SC,"Orangeburg County, South Carolina",20600,9050,11550,45075,34218,33986,8236,40299,7329,74285,15565,63.3,71,stable,48,54,89208,0,0
SC,"Pickens County, South Carolina",22545,10766,11779,45077,41459,51713,7705,52787,7184,104500,14889,74,99,stable,51.5,69,121691,0,0
SC,"Richland County, South Carolina",62611,26738,35873,45079,49131,151728,23127,176936,21861,328664,44988,70.1,242,stable,49.3,167,407051,0,0
SC,"Saluda County, South Carolina",4062,1813,2249,45081,38827,7809,2323,8061,1629,15870,3952,55.1,14,stable,49.6,13,20053,0,0
SC,"Spartanburg County, South Carolina",49665,21832,27833,45083,43907,116394,21970,128890,19821,245284,41791,73.1,241,stable,55,179,297302,0,0
SC,"Sumter County, South Carolina",18943,8146,10797,45085,41332,41053,7699,47931,7265,88984,14964,72,84,stable,49,57,107480,0,0
SC,"Union County, South Carolina",5605,2257,3348,45087,34033,11273,1890,12828,1661,24101,3551,94.2,36,stable,67.7,26,27777,0,0
SC,"Williamsburg County, South Carolina",9349,3950,5399,45089,28297,11827,2608,14320,2656,26147,5264,66.3,29,rising,59.4,26,32535,1,0
SC,"York County, South Carolina",31814,13652,18162,45091,54117,100411,14632,109930,13654,210341,28286,66.8,157,stable,54,124,251195,0,0
SD,"Beadle County, South Dakota",3708,1647,2061,46005,46267,8284,702,7876,999,16160,1701,48.6,12,stable,30.7,8,18372,0,0
SD,"Bon Homme County, South Dakota",576,268,308,46009,45254,2563,127,2707,185,5270,312,55.7,6,stable,50.4,5,6985,0,0
SD,"Brookings County, South Dakota",4811,2411,2400,46011,50082,15337,1441,14945,1191,30282,2632,53.5,14,stable,37.9,10,33897,0,0
SD,"Brown County, South Dakota",3613,1635,1978,46013,53100,16936,1375,17705,1494,34641,2869,57.5,27,stable,44.8,22,38785,0,0
SD,"Brule County, South Dakota",789,351,438,46015,49531,2230,329,2358,273,4588,602,83,6,stable,53.7,4,5281,0,0
SD,"Butte County, South Dakota",1082,514,568,46019,41920,4029,966,4329,836,8358,1802,60.8,9,stable,59.5,8,10283,0,0
SD,"Charles Mix County, South Dakota",1970,923,1047,46023,43109,3578,909,3650,869,7228,1778,48.9,6,stable,34.5,4,9383,0,0
SD,"Clay County, South Dakota",3255,1660,1595,46027,36608,6070,851,6226,656,12296,1507,61.4,7,stable,51,6,13964,0,0
SD,"Codington County, South Dakota",2806,1298,1508,46029,48912,12669,1152,12462,1165,25131,2317,49.4,16,stable,45.2,15,27939,0,0
SD,"Custer County, South Dakota",850,373,477,46033,52218,3586,437,3623,442,7209,879,38.6,6,stable,32.9,5,8446,0,0
SD,"Davison County, South Dakota",2379,1314,1065,46035,49991,8778,1039,9135,456,17913,1495,64.2,17,stable,48.3,13,19858,0,0
SD,"Day County, South Dakota",1200,559,641,46037,39216,2426,334,2393,305,4819,639,45,4,stable,43.6,5,5539,0,0
SD,"Deuel County, South Dakota",330,160,170,46039,53152,2086,138,1909,140,3995,278,48,3,stable,46.8,3,4333,0,0
SD,"Fall River County, South Dakota",1097,543,554,46047,45997,2999,348,3005,351,6004,699,63.6,8,falling,55,7,6867,0,1
SD,"Grant County, South Dakota",582,228,354,46051,51272,3334,406,3284,156,6618,562,55.1,6,stable,33.3,3,7142,0,0
SD,"Gregory County, South Dakota",769,363,406,46053,37540,1909,213,1848,206,3757,419,75.8,5,stable,57.3,4,4201,0,0
SD,"Hughes County, South Dakota",1663,776,887,46065,59177,7561,789,7576,567,15137,1356,52.1,10,stable,30.7,6,17555,0,0
SD,"Hutchinson County, South Dakota",926,498,428,46067,45075,3235,294,3261,193,6496,487,41.9,5,stable,31.8,4,7301,0,0
SD,"Kingsbury County, South Dakota",505,219,286,46077,53828,2374,181,2323,141,4697,322,62.6,6,stable,45.5,4,4990,0,0
SD,"Lake County, South Dakota",1732,766,966,46079,54535,5612,476,5438,410,11050,886,46,7,stable,35.6,6,12622,0,0
SD,"Lawrence County, South Dakota",3115,1219,1896,46081,45548,10268,1828,10732,1570,21000,3398,47.8,15,stable,37.5,12,24827,0,0
SD,"Lincoln County, South Dakota",2158,859,1299,46083,76094,23479,1225,23552,1339,47031,2564,48.9,18,stable,33.8,12,52849,0,0
SD,"McCook County, South Dakota",467,218,249,46087,56954,2512,236,2556,160,5068,396,86,7,stable,57.6,5,5599,0,0
SD,"Marshall County, South Dakota",701,296,405,46091,51788,2212,202,1946,276,4158,478,53.7,4,stable,48.5,3,4769,0,0
SD,"Meade County, South Dakota",2764,1272,1492,46093,52473,11335,1390,10920,1420,22255,2810,56.4,15,stable,44.9,12,26986,0,0
SD,"Minnehaha County, South Dakota",20578,9155,11423,46099,53525,78600,9208,81047,7340,159647,16548,65.3,110,stable,52.1,87,185197,0,0
SD,"Pennington County, South Dakota",13079,5673,7406,46103,50890,44048,6865,45946,6281,89994,13146,66.1,78,stable,46.9,55,108702,0,0
SD,"Roberts County, South Dakota",2031,969,1062,46109,48614,4011,1062,4127,920,8138,1982,46.4,6,stable,34.9,5,10311,0,0
SD,"Spink County, South Dakota",798,340,458,46115,48217,3000,267,2865,288,5865,555,48.8,5,stable,46.2,5,6524,0,0
SD,"Todd County, South Dakota",4471,2116,2355,46121,31128,3268,1556,3624,1455,6892,3011,*,3 or fewer,stable,64.7,3,9959,0,0
SD,"Turner County, South Dakota",761,305,456,46125,53378,3818,305,3733,289,7551,594,56.2,6,stable,35.7,4,8209,0,0
SD,"Union County, South Dakota",783,292,491,46127,64471,6911,503,6929,379,13840,882,80.2,14,stable,44,8,14909,0,0
SD,"Walworth County, South Dakota",650,241,409,46129,43221,2297,304,2438,278,4735,582,47,5,stable,42.9,4,5443,0,0
SD,"Yankton County, South Dakota",2993,1298,1695,46135,48176,9303,1212,9798,833,19101,2045,61.4,18,falling,43.5,13,22702,0,1
TN,"Anderson County, Tennessee",13309,5830,7479,47001,42880,31601,4647,34889,3459,66490,8106,71.1,75,stable,64.7,69,75749,0,0
TN,"Bedford County, Tennessee",7727,3542,4185,47003,41984,18606,3862,20181,2944,38787,6806,69.4,35,stable,56.4,28,47183,0,0
TN,"Benton County, Tennessee",3667,1733,1934,47005,33240,6716,1206,6888,1290,13604,2496,104.7,26,stable,89,22,16129,0,0
TN,"Bledsoe County, Tennessee",2697,1234,1463,47007,37013,5313,1192,5129,829,10442,2021,85.2,15,stable,57.3,10,14502,0,0
TN,"Blount County, Tennessee",17305,7389,9916,47009,48286,52291,7725,57700,6300,109991,14025,79,130,stable,54.2,89,127253,0,0
TN,"Bradley County, Tennessee",19357,8597,10760,47011,42114,41416,7723,45811,6183,87227,13906,81,97,stable,56.7,67,104091,0,0
TN,"Campbell County, Tennessee",9203,4004,5199,47013,32028,16363,2910,18002,2375,34365,5285,105.9,60,stable,86.8,49,39752,0,0
TN,"Cannon County, Tennessee",2500,1154,1346,47015,41533,5791,915,6198,715,11989,1630,59.7,11,stable,58.8,10,13840,0,0
TN,"Carroll County, Tennessee",5713,2656,3057,47017,35508,11861,1745,12746,1520,24607,3265,80,32,stable,61,25,27910,0,0
TN,"Carter County, Tennessee",13021,6094,6927,47019,33213,22671,4536,24963,3704,47634,8240,78.3,63,stable,67.2,54,56486,0,0
TN,"Cheatham County, Tennessee",5396,2410,2986,47021,51857,16596,2798,17778,1931,34374,4729,92.3,38,stable,80.6,32,39741,0,0
TN,"Chester County, Tennessee",3516,1579,1937,47023,40167,6992,1252,7753,1251,14745,2503,76.7,16,rising,48.5,10,17471,1,0
TN,"Claiborne County, Tennessee",6658,2951,3707,47025,34899,13480,1832,14369,1537,27849,3369,107.7,47,stable,84.2,36,31709,0,0
TN,"Clay County, Tennessee",1801,820,981,47027,28804,3289,504,3422,472,6711,976,76.1,9,stable,68.8,9,7771,0,0
TN,"Cocke County, Tennessee",9111,4022,5089,47029,31187,14340,2761,15175,2755,29515,5516,96.9,50,stable,84.1,42,35162,0,0
TN,"Coffee County, Tennessee",9818,4470,5348,47031,41590,21912,3746,23965,3245,45877,6991,84.4,57,stable,62.8,43,54277,0,0
TN,"Crockett County, Tennessee",2838,1340,1498,47033,35464,5490,1360,6572,965,12062,2325,64.6,12,stable,58.2,11,14601,0,0
TN,"Cumberland County, Tennessee",9300,4080,5220,47035,38576,23269,4419,25675,3444,48944,7863,79.8,80,stable,62.7,65,58229,0,0
TN,"Davidson County, Tennessee",116031,52503,63528,47037,48368,257116,55169,294365,43931,551481,99100,72,424,falling,57.1,331,678889,0,1
TN,"Decatur County, Tennessee",2470,1098,1372,47039,37263,4817,783,5231,628,10048,1411,87.4,16,stable,76.1,14,11660,0,0
TN,"DeKalb County, Tennessee",3887,1562,2325,47041,38319,7851,1534,8119,1287,15970,2821,91.3,22,stable,71.9,17,19182,0,0
TN,"Dickson County, Tennessee",8116,3460,4656,47043,44680,21205,3245,22550,2955,43755,6200,87.9,50,stable,67.1,38,51487,0,0
TN,"Dyer County, Tennessee",6646,2680,3966,47045,42468,16136,1960,17505,1914,33641,3874,77.9,37,stable,65.4,30,37893,0,0
TN,"Fayette County, Tennessee",5351,2427,2924,47047,54890,16771,2081,17849,1678,34620,3759,58.7,31,stable,49.4,25,39165,0,0
TN,"Fentress County, Tennessee",4577,2281,2296,47049,30259,7050,1592,7986,1068,15036,2660,92.7,24,stable,83,21,17917,0,0
TN,"Franklin County, Tennessee",6669,2889,3780,47051,42773,17691,2152,18771,2174,36462,4326,70.6,41,stable,54.4,31,41449,0,0
TN,"Gibson County, Tennessee",9080,3806,5274,47053,38457,19759,3175,22788,2799,42547,5974,80.5,52,stable,62.1,40,49399,0,0
TN,"Giles County, Tennessee",4627,2011,2616,47055,41093,11866,2083,13097,1514,24963,3597,82.1,33,stable,59.9,24,28946,0,0
TN,"Grainger County, Tennessee",4647,2091,2556,47057,35391,9876,1399,10088,1227,19964,2626,82.2,26,stable,73,23,22846,0,0
TN,"Greene County, Tennessee",13647,6146,7501,47059,35196,27714,5087,30385,4211,58099,9298,96.4,94,stable,72.2,70,68580,0,0
TN,"Grundy County, Tennessee",3797,1683,2114,47061,27373,5078,1516,5653,1091,10731,2607,96.1,19,stable,81.9,16,13441,0,0
TN,"Hamblen County, Tennessee",13193,6285,6908,47063,37617,24472,5810,27420,4556,51892,10366,77.9,64,stable,68.7,55,63402,0,0
TN,"Hamilton County, Tennessee",54036,23604,30432,47065,48248,143730,21800,161207,17627,304937,39427,68.4,286,stable,49.6,206,354098,0,0
TN,"Hancock County, Tennessee",1793,706,1087,47067,26898,2707,442,2959,371,5666,813,83.1,9,stable,67.7,7,6572,0,0
TN,"Hardeman County, Tennessee",5636,2479,3157,47069,31801,9478,1499,10360,1465,19838,2964,94.2,31,stable,64.3,21,25707,0,0
TN,"Hardin County, Tennessee",5920,2494,3426,47071,35290,10421,2093,11258,1736,21679,3829,85.9,33,stable,63.6,24,25756,0,0
TN,"Hawkins County, Tennessee",10661,4410,6251,47073,36927,23655,3800,26009,2563,49664,6363,102.7,79,stable,74.3,57,56471,0,0
TN,"Haywood County, Tennessee",4107,1758,2349,47075,34182,6982,1432,8640,961,15622,2393,80.4,18,stable,57.3,13,18023,0,0
TN,"Henderson County, Tennessee",5925,2512,3413,47077,38745,11764,1556,12878,1541,24642,3097,93.4,32,stable,67.9,23,28015,0,0
TN,"Henry County, Tennessee",5862,2421,3441,47079,38234,13056,2240,14504,1927,27560,4167,88.4,45,stable,76.7,38,32147,0,0
TN,"Hickman County, Tennessee",4738,2218,2520,47081,36334,9243,2136,9564,1870,18807,4006,91.5,27,stable,73.2,21,24363,0,0
TN,"Houston County, Tennessee",1860,949,911,47083,39401,3525,482,3603,487,7128,969,96.8,11,stable,80.8,10,8149,0,0
TN,"Humphreys County, Tennessee",2856,1312,1544,47085,41949,7632,1281,8283,831,15915,2112,99.2,26,stable,76.4,20,18135,0,0
TN,"Jackson County, Tennessee",3034,1443,1591,47087,31534,4755,970,4997,596,9752,1566,102.8,18,stable,79.9,14,11509,0,0
TN,"Jefferson County, Tennessee",8343,3626,4717,47089,42417,22099,3314,23371,2941,45470,6255,68.9,49,stable,51.1,36,53240,0,0
TN,"Johnson County, Tennessee",4123,1916,2207,47091,30763,6761,1094,7420,917,14181,2011,88,23,stable,64.8,17,17830,0,0
TN,"Knox County, Tennessee",69061,31168,37893,47093,48701,188715,25474,205163,21468,393878,46942,73.8,357,falling,55.9,268,451324,0,1
TN,"Lake County, Tennessee",1319,538,781,47095,30086,1964,378,2389,250,4353,628,96.8,9,stable,88.9,8,7576,0,0
TN,"Lauderdale County, Tennessee",6532,2877,3655,47097,30281,9660,1851,11096,1950,20756,3801,92.9,28,stable,78.7,23,26936,0,0
TN,"Lawrence County, Tennessee",8443,3608,4835,47099,37814,16920,3586,17705,3572,34625,7158,78.2,43,stable,68.3,37,42564,0,0
TN,"Lewis County, Tennessee",2292,1189,1103,47101,36621,5069,822,4928,891,9997,1713,116.1,19,stable,81.6,13,11854,0,0
TN,"Lincoln County, Tennessee",5517,2540,2977,47103,40389,14055,2213,15084,1824,29139,4037,64.3,30,stable,55.4,25,33743,0,0
TN,"Loudon County, Tennessee",7185,3503,3682,47105,51107,21340,2980,22655,2853,43995,5833,69.2,58,stable,52.7,42,51130,0,0
TN,"McMinn County, Tennessee",10220,4598,5622,47107,38535,21366,3828,23727,2762,45093,6590,81.4,59,falling,68.2,48,52639,0,1
TN,"McNairy County, Tennessee",5319,2199,3120,47109,32557,10633,1884,11543,1691,22176,3575,89.5,33,stable,77.8,28,26066,0,0
TN,"Macon County, Tennessee",4218,1836,2382,47111,33509,9374,1653,10107,1307,19481,2960,100.4,27,stable,77.5,21,23177,0,0
TN,"Madison County, Tennessee",18521,7912,10609,47113,42544,39539,6281,45874,5340,85413,11621,70.7,78,stable,52.1,57,97610,0,0
TN,"Marion County, Tennessee",5350,2191,3159,47115,41348,11793,1866,12648,1684,24441,3550,102.9,40,stable,69.9,27,28487,0,0
TN,"Marshall County, Tennessee",4986,2160,2826,47117,42661,12891,2314,13708,1923,26599,4237,91.6,33,falling,71.9,26,31552,0,1
TN,"Maury County, Tennessee",12667,5701,6966,47119,47692,34469,5451,38701,4290,73170,9741,73.5,69,stable,61,57,87757,0,0
TN,"Meigs County, Tennessee",2377,906,1471,47121,34424,4855,816,5065,839,9920,1655,83.7,15,stable,74,12,11830,0,0
TN,"Monroe County, Tennessee",8627,4032,4595,47123,35291,19103,3290,19523,2866,38626,6156,98.6,60,stable,73.4,45,45771,0,0
TN,"Montgomery County, Tennessee",28750,12557,16193,47125,50344,70256,10425,82598,9307,152854,19732,84.3,106,stable,61.2,75,193479,0,0
TN,"Moore County, Tennessee",668,268,400,47127,49427,2754,284,2852,367,5606,651,63.5,6,stable,35.3,3,6322,0,0
TN,"Morgan County, Tennessee",4185,2019,2166,47129,39049,7940,1055,8613,955,16553,2010,94.3,26,stable,71.7,19,21498,0,0
TN,"Obion County, Tennessee",6309,2881,3428,47131,40281,12513,2215,14041,1941,26554,4156,72.6,31,falling,71.5,30,30639,0,1
TN,"Overton County, Tennessee",4668,2273,2395,47133,35287,9276,1406,9830,1293,19106,2699,98.2,32,stable,84.8,26,22129,0,0
TN,"Perry County, Tennessee",1995,865,1130,47135,31425,3169,731,3164,667,6333,1398,93.8,11,stable,77.3,9,7929,0,0
TN,"Pickett County, Tennessee",808,315,493,47137,36773,2078,391,2231,305,4309,696,94.8,8,stable,65.2,6,5146,0,0
TN,"Polk County, Tennessee",3094,1481,1613,47139,38925,7102,1098,7282,968,14384,2066,116,28,stable,103.3,25,16773,0,0
TN,"Putnam County, Tennessee",17830,8209,9621,47141,35343,29982,5917,32553,4582,62535,10499,71.6,62,stable,54.9,47,74553,0,0
TN,"Rhea County, Tennessee",7664,3510,4154,47143,36146,13770,2097,14544,1610,28314,3707,99,41,stable,77.5,31,32526,0,0
TN,"Roane County, Tennessee",9620,4479,5141,47145,40854,22459,3278,24188,2686,46647,5964,88.6,72,stable,71.1,58,52753,0,0
TN,"Robertson County, Tennessee",8005,3441,4564,47147,53151,27866,4735,30884,3162,58750,7897,83.2,59,stable,65.1,45,68570,0,0
TN,"Rutherford County, Tennessee",34475,15822,18653,47149,56219,119135,18793,127230,15032,246365,33825,68.5,144,stable,50.3,102,298612,0,0
TN,"Scott County, Tennessee",5903,2663,3240,47151,30246,8916,1704,9606,1510,18522,3214,109.2,29,stable,94.9,24,21950,0,0
TN,"Sequatchie County, Tennessee",2335,979,1356,47153,45408,6370,702,6438,861,12808,1563,96.8,18,stable,86.6,16,14811,0,0
TN,"Sevier County, Tennessee",14128,6136,7992,47155,42258,35661,9701,38995,8383,74656,18084,83.5,99,falling,61.8,72,95946,0,1
TN,"Shelby County, Tennessee",196471,87291,109180,47157,46224,362755,75492,425842,61338,788597,136830,67.3,587,stable,53.2,457,938069,0,0
TN,"Smith County, Tennessee",3066,1307,1759,47159,43914,8337,1010,8590,954,16927,1964,92.7,21,stable,81.4,18,19295,0,0
TN,"Stewart County, Tennessee",2560,1236,1324,47161,42023,5719,822,5829,726,11548,1548,90.8,17,stable,69.5,12,13259,0,0
TN,"Sullivan County, Tennessee",26924,12365,14559,47163,40346,64972,9918,71960,8207,136932,18125,75.7,174,stable,59.7,138,156791,0,0
TN,"Sumner County, Tennessee",15644,6676,8968,47165,57382,72373,9532,78051,8131,150424,17663,65.9,121,stable,51.8,92,175989,0,0
TN,"Tipton County, Tennessee",8292,3516,4776,47167,53669,25881,4018,27879,2992,53760,7010,94.6,60,stable,74.6,45,61870,0,0
TN,"Trousdale County, Tennessee",1345,614,731,47169,41029,3132,702,3604,304,6736,1006,101.4,9,stable,59.6,6,8042,0,0
TN,"Unicoi County, Tennessee",3974,1790,2184,47171,33210,7447,1353,7908,1026,15355,2379,89.3,25,stable,70.8,20,17860,0,0
TN,"Union County, Tennessee",4036,1575,2461,47173,37351,8076,1337,8249,1273,16325,2610,100.7,24,stable,76.2,18,19119,0,0
TN,"Van Buren County, Tennessee",988,523,465,47175,40439,2385,342,2324,444,4709,786,55.8,4,stable,53,4,5677,0,0
TN,"Warren County, Tennessee",8329,3964,4365,47177,35376,16252,3256,17765,2210,34017,5466,84.7,42,stable,64.4,33,40435,0,0
TN,"Washington County, Tennessee",21842,9588,12254,47179,42817,52464,7566,56336,7167,108800,14733,71.6,110,stable,55.3,84,126302,0,0
TN,"Wayne County, Tennessee",3211,1619,1592,47181,30701,6169,1124,6540,956,12709,2080,79.1,18,stable,72.6,16,16748,0,0
TN,"Weakley County, Tennessee",6075,2810,3265,47183,37037,14459,2122,15906,1468,30365,3590,72.4,31,stable,61.2,26,33960,0,0
TN,"White County, Tennessee",5011,2341,2670,47185,34901,10891,1717,11526,1711,22417,3428,89.7,33,stable,65.7,23,26521,0,0
TN,"Williamson County, Tennessee",10054,4225,5829,47187,96565,91344,5695,96717,5137,188061,10832,46.6,77,stable,36.5,60,211672,0,0
TN,"Wilson County, Tennessee",12132,4886,7246,47189,61070,52625,6781,56770,5281,109395,12062,76.5,98,stable,55.3,68,128911,0,0
TX,"Anderson County, Texas",8274,3779,4495,48001,41327,18394,4247,18148,4112,36542,8359,78.1,49,stable,70.1,44,57580,0,0
TX,"Andrews County, Texas",2032,832,1200,48003,70423,7005,1505,6326,1847,13331,3352,64.3,9,stable,47.6,7,18105,0,0
TX,"Angelina County, Texas",16497,7061,9436,48005,44223,32551,8647,36126,8248,68677,16895,76.4,74,stable,48.3,47,88255,0,0
TX,"Aransas County, Texas",4509,2097,2412,48007,41690,9334,2419,9949,2164,19283,4583,78.1,33,stable,56.6,24,25350,0,0
TX,"Archer County, Texas",862,352,510,48009,60275,3703,631,3866,508,7569,1139,61.5,8,stable,45.9,5,8715,0,0
TX,"Atascosa County, Texas",7619,3141,4478,48013,52192,18670,4520,18867,4536,37537,9056,42.4,21,stable,31.9,16,48435,0,0
TX,"Austin County, Texas",3289,1377,1912,48015,53687,11830,2424,11973,2414,23803,4838,48,18,stable,41,15,29563,0,0
TX,"Bandera County, Texas",2662,1322,1340,48019,49863,8362,1913,8601,1726,16963,3639,58.8,20,stable,42.9,15,21269,0,0
TX,"Bastrop County, Texas",10664,4867,5797,48021,54821,30120,7315,30045,7386,60165,14701,69.2,54,stable,56.6,43,80527,0,0
TX,"Baylor County, Texas",423,143,280,48023,36373,1359,397,1524,275,2883,672,80.4,5,stable,57.6,4,3618,0,0
TX,"Bee County, Texas",5274,2344,2930,48025,42302,9837,2439,9597,3215,19434,5654,50.9,15,stable,33.2,9,32874,0,0
TX,"Bell County, Texas",48543,21926,26617,48027,50550,122102,21650,138608,21336,260710,42986,81.5,200,stable,54.1,130,334941,0,0
TX,"Bexar County, Texas",312088,140680,171408,48029,51150,708529,166188,762263,156662,1470792,322850,45.1,702,falling,34.5,528,1897753,0,1
TX,"Blanco County, Texas",954,451,503,48031,55504,4327,1037,4158,1089,8485,2126,46.3,8,stable,28.2,5,11004,0,0
TX,"Bosque County, Texas",2549,1144,1405,48035,44674,6862,1821,7135,1805,13997,3626,58.4,17,stable,59.2,18,17891,0,0
TX,"Bowie County, Texas",16693,7537,9156,48037,42670,34412,7917,38080,7433,72492,15350,80.2,88,stable,58.7,63,93389,0,0
TX,"Brazoria County, Texas",35762,16016,19746,48039,69749,132481,26179,136174,26559,268655,52738,63,175,stable,47.6,130,346312,0,0
TX,"Brazos County, Texas",53207,25213,27994,48041,39808,85232,16282,85931,13975,171163,30257,49,62,stable,37.2,47,215037,0,0
TX,"Brewster County, Texas",1238,508,730,48043,38395,3454,921,3970,808,7424,1729,36.4,4,stable,33.4,4,9145,0,0
TX,"Brown County, Texas",6581,2868,3713,48049,41962,14557,3542,16086,2617,30643,6159,65.2,34,stable,52.3,28,37896,0,0
TX,"Burleson County, Texas",2761,1259,1502,48051,51821,7037,1491,6762,1830,13799,3321,73.1,18,stable,53.6,13,17460,0,0
TX,"Burnet County, Texas",6989,3317,3672,48053,49732,17966,3763,18362,3739,36328,7502,65.3,43,stable,45.7,30,45463,0,0
TX,"Caldwell County, Texas",7169,3540,3629,48055,47233,13968,4891,14535,4039,28503,8930,65.1,26,stable,45.9,18,40522,0,0
TX,"Calhoun County, Texas",4136,1987,2149,48057,51078,8824,1912,8892,1844,17716,3756,70,18,stable,46.3,12,21895,0,0
TX,"Callahan County, Texas",2548,1107,1441,48059,40981,4976,1607,5360,1508,10336,3115,80.4,16,stable,69.4,14,13557,0,0
TX,"Cameron County, Texas",139768,63753,76015,48061,33266,137295,62556,146719,68645,284014,131201,38.4,143,stable,24,89,422156,0,0
TX,"Camp County, Texas",2454,1046,1408,48063,37851,4688,1389,4971,1400,9659,2789,74.8,12,stable,53.4,9,12682,0,0
TX,"Carson County, Texas",435,202,233,48065,66023,2499,411,2655,455,5154,866,44.5,4,stable,45,4,5969,0,0
TX,"Cass County, Texas",5915,2548,3367,48067,37352,11536,2986,12405,2993,23941,5979,68.9,32,stable,58.8,27,30313,0,0
TX,"Castro County, Texas",1339,672,667,48069,39459,2591,1412,2678,1177,5269,2589,50.7,5,stable,35.5,3,7656,0,0
TX,"Chambers County, Texas",3921,1677,2244,48071,70544,15184,3360,15082,3420,30266,6780,68.3,21,stable,56.9,17,38863,0,0
TX,"Cherokee County, Texas",10688,4875,5813,48073,39595,19081,5260,19740,4874,38821,10134,83.3,51,stable,60.3,37,51542,0,0
TX,"Childress County, Texas",1177,573,604,48075,36633,2421,470,2582,350,5003,820,72.5,6,stable,50.5,4,7088,0,0
TX,"Clay County, Texas",1246,620,626,48077,48297,4461,766,4233,943,8694,1709,68.8,11,stable,55.3,9,10360,0,0
TX,"Coleman County, Texas",1924,720,1204,48083,35156,3084,1115,3194,1106,6278,2221,70.7,10,stable,61.8,9,8338,0,0
TX,"Collin County, Texas",64824,30107,34717,48085,84735,364117,57505,384036,53416,748153,110921,49.4,286,stable,36.7,207,914127,0,0
TX,"Colorado County, Texas",3081,1430,1651,48089,46618,8211,1852,8609,1745,16820,3597,65.6,20,stable,57.6,18,20870,0,0
TX,"Comal County, Texas",10423,4122,6301,48091,65833,49481,9194,51021,8970,100502,18164,58.1,83,stable,42.7,61,129048,0,0
TX,"Comanche County, Texas",3107,1420,1687,48093,37470,4842,1755,5054,1778,9896,3533,76.4,17,stable,61.6,13,13430,0,0
TX,"Cooke County, Texas",5292,2322,2970,48097,52406,15879,2963,16252,3158,32131,6121,62.1,32,stable,53.7,27,39229,0,0
TX,"Coryell County, Texas",8631,3528,5103,48099,49340,23726,2768,29019,3462,52745,6230,81.2,41,stable,58.1,28,75503,0,0
TX,"Crosby County, Texas",1358,544,814,48107,37434,2246,626,2210,834,4456,1460,57,5,stable,38.2,3,5977,0,0
TX,"Dallas County, Texas",472926,211723,261203,48113,50270,887696,324950,964891,287195,1852587,612145,56,1078,falling,42.8,802,2553385,0,1
TX,"Dawson County, Texas",1924,729,1195,48115,41095,4527,1246,4383,1466,8910,2712,59.2,9,stable,37.1,6,13520,0,0
TX,"Deaf Smith County, Texas",3955,1687,2268,48117,43373,7472,1901,7461,2224,14933,4125,55.1,10,stable,41.7,7,18952,0,0
TX,"Delta County, Texas",1177,554,623,48119,42432,2060,509,2158,425,4218,934,58.8,5,stable,50.8,4,5217,0,0
TX,"Denton County, Texas",63220,27578,35642,48121,75050,304587,52747,318578,51497,623165,104244,53.3,245,stable,37.4,169,780612,0,0
TX,"DeWitt County, Texas",2817,1289,1528,48123,49736,7634,1642,7941,1559,15575,3201,57.9,17,stable,52.8,15,20797,0,0
TX,"Donley County, Texas",585,247,338,48129,36681,1346,377,1596,221,2942,598,74,5,stable,56.3,4,3499,0,0
TX,"Duval County, Texas",2617,1093,1524,48131,33939,4007,1549,3919,1571,7926,3120,45.6,7,stable,33,5,11388,0,0
TX,"Eastland County, Texas",3162,1312,1850,48133,34888,6769,2117,7380,1794,14149,3911,71,21,stable,58.8,16,18171,0,0
TX,"Ector County, Texas",19162,7745,11417,48135,57150,57129,17173,55289,18582,112418,35755,69.9,85,stable,50.4,61,159436,0,0
TX,"Ellis County, Texas",18755,8310,10445,48139,62465,62565,14337,64983,13907,127548,28244,64.8,91,stable,50.2,68,163632,0,0
TX,"El Paso County, Texas",185728,81700,104028,48141,41637,283850,99022,317237,104788,601087,203810,32.9,231,stable,24.3,169,835593,0,0
TX,"Erath County, Texas",9340,3732,5608,48143,41416,15099,4392,15903,4153,31002,8545,53.1,21,stable,34.4,14,41122,0,0
TX,"Falls County, Texas",3417,1589,1828,48145,36079,5895,1842,6431,1364,12326,3206,61,14,stable,43.5,10,17142,0,0
TX,"Fannin County, Texas",5305,2544,2761,48147,44071,12352,2745,13042,2688,25394,5433,78.7,36,stable,58.8,27,33693,0,0
TX,"Fayette County, Texas",3021,1282,1739,48149,47808,10407,1766,10148,2107,20555,3873,54.2,22,stable,33.3,14,25110,0,0
TX,"Fisher County, Texas",666,252,414,48151,41406,1412,390,1642,390,3054,780,46.7,3,stable,46.9,3,3827,0,0
TX,"Floyd County, Texas",1375,613,762,48153,41026,2239,772,2521,597,4760,1369,61.1,5,stable,44.9,4,5901,0,0
TX,"Fort Bend County, Texas",53761,23618,30143,48157,89152,270364,48895,285749,48185,556113,97080,43.1,188,stable,31.9,132,716087,0,0
TX,"Franklin County, Texas",1726,878,848,48159,41537,4374,940,4210,961,8584,1901,78.4,12,stable,51.4,8,10651,0,0
TX,"Freestone County, Texas",2683,1178,1505,48161,44301,7124,1715,7321,1907,14445,3622,60.1,16,stable,49,13,19691,0,0
TX,"Frio County, Texas",3321,1607,1714,48163,36404,6192,1524,5279,2060,11471,3584,39.2,6,stable,31.9,5,18793,0,0
TX,"Gaines County, Texas",2177,1018,1159,48165,57635,6378,3133,6053,3244,12431,6377,46.8,7,stable,43.3,6,20051,0,0
TX,"Galveston County, Texas",41985,18622,23363,48167,62313,124825,25166,129851,23892,254676,49058,63.2,192,stable,54.5,162,322225,0,0
TX,"Gillespie County, Texas",2791,1403,1388,48171,54859,9971,2226,10717,2091,20688,4317,48.8,25,stable,37.5,19,25963,0,0
TX,"Goliad County, Texas",1358,685,673,48175,51226,3155,413,3291,434,6446,847,65.5,7,stable,47.9,5,7531,0,0
TX,"Gonzales County, Texas",4009,1702,2307,48177,42983,7522,2441,7408,2512,14930,4953,47.3,12,stable,40.4,10,20573,0,0
TX,"Gray County, Texas",2824,1266,1558,48179,43288,8533,2177,8407,2220,16940,4397,90.1,25,stable,57.2,16,23210,0,0
TX,"Grayson County, Texas",19420,8783,10637,48181,47952,47981,11386,51363,10713,99344,22099,78,120,stable,56.5,87,125467,0,0
TX,"Gregg County, Texas",21769,9209,12560,48183,47639,46507,12687,50620,11455,97127,24142,71.9,97,stable,55.6,76,124108,0,0
TX,"Grimes County, Texas",4701,2278,2423,48185,46195,9497,2198,9357,2658,18854,4856,48.2,15,stable,43.2,14,27512,0,0
TX,"Guadalupe County, Texas",13924,5939,7985,48187,62420,58660,10828,61380,10367,120040,21195,58.6,80,stable,41.6,56,151249,0,0
TX,"Hale County, Texas",7548,3137,4411,48189,43375,12814,3663,13412,3543,26226,7206,60,21,stable,43.1,15,34360,0,0
TX,"Hamilton County, Texas",1159,545,614,48193,42432,3075,826,3688,443,6763,1269,59.4,9,stable,41.9,7,8159,0,0
TX,"Hardin County, Texas",6684,2682,4002,48199,52614,22225,4897,22861,4952,45086,9849,66.4,42,stable,53.8,34,55865,0,0
TX,"Harris County, Texas",774568,348592,425976,48201,54457,1618879,533586,1696701,486665,3315580,1020251,56,1768,stable,40.3,"1,243",4538028,0,0
TX,"Harrison County, Texas",11151,5009,6142,48203,45974,26040,6171,27465,6090,53505,12261,79.5,62,stable,60,45,66746,0,0
TX,"Haskell County, Texas",1030,467,563,48207,39850,2190,440,1988,403,4178,843,40.6,4,stable,60.1,5,5737,0,0
TX,"Hays County, Texas",28783,12839,15944,48209,58583,71610,15558,77014,11636,148624,27194,47.2,57,stable,36.1,44,194739,0,0
TX,"Hemphill County, Texas",502,266,236,48211,62813,1552,448,1536,527,3088,975,86.4,3,stable,76.3,3,4264,0,0
TX,"Henderson County, Texas",14572,6271,8301,48213,41607,29559,8648,32037,7881,61596,16529,89.9,104,stable,60.2,70,79545,0,0
TX,"Hidalgo County, Texas",277104,126943,150161,48215,34782,257222,135536,272464,146125,529686,281661,32.7,200,falling,22.5,137,842304,0,1
TX,"Hill County, Texas",7049,3091,3958,48217,41382,13420,3402,13665,3769,27085,7171,69.9,35,stable,63.1,31,34855,0,0
TX,"Hockley County, Texas",3297,1407,1890,48219,50665,8887,2518,9184,2584,18071,5102,51.8,13,stable,35,8,23433,0,0
TX,"Hood County, Texas",6161,2476,3685,48221,56100,21323,4472,22328,4299,43651,8771,64.2,56,stable,47.9,42,55423,0,0
TX,"Hopkins County, Texas",6972,2980,3992,48223,44396,13492,3928,13916,3871,27408,7799,66,29,stable,49,22,36223,0,0
TX,"Houston County, Texas",4918,1850,3068,48225,32698,7507,1746,8766,1747,16273,3493,63.1,22,stable,47.4,16,22785,0,0
TX,"Howard County, Texas",4787,1873,2914,48227,49575,12648,2774,12681,2779,25329,5553,73.3,28,stable,46.9,18,37206,0,0
TX,"Hunt County, Texas",16112,7513,8599,48231,45197,34231,8835,36106,8048,70337,16883,80.2,82,stable,63.1,63,89844,0,0
TX,"Hutchinson County, Texas",3493,1394,2099,48233,49353,9028,1827,8766,2079,17794,3906,58.4,15,stable,45.3,12,21734,0,0
TX,"Jack County, Texas",1324,576,748,48237,50324,3106,830,3066,731,6172,1561,68,7,stable,54.1,6,8878,0,0
TX,"Jackson County, Texas",1765,582,1183,48239,54926,5925,1003,6262,1059,12187,2062,57.5,11,stable,51.8,10,14816,0,0
TX,"Jasper County, Texas",5912,2342,3570,48241,40820,13089,3502,14946,3329,28035,6831,60.3,29,stable,53,25,35506,0,0
TX,"Jefferson County, Texas",47095,19637,27458,48245,43540,89861,26481,96227,26458,186088,52939,65.7,178,stable,49.8,134,254308,0,0
TX,"Jim Wells County, Texas",9128,4274,4854,48249,42986,15575,4670,16196,4620,31771,9290,40.7,18,stable,35.4,16,41382,0,0
TX,"Johnson County, Texas",18392,7958,10434,48251,58135,59557,16156,61348,15792,120905,31948,71.5,109,stable,56.1,86,159990,0,0
TX,"Jones County, Texas",2285,894,1391,48253,43897,4378,973,5783,1398,10161,2371,60.1,14,stable,48.5,11,19970,0,0
TX,"Karnes County, Texas",3079,1427,1652,48255,45502,5180,1052,5187,770,10367,1822,72,12,stable,41.1,7,14975,0,0
TX,"Kaufman County, Texas",15016,6368,8648,48257,60391,42193,10864,45071,10169,87264,21033,79.4,78,stable,54.7,53,114690,0,0
TX,"Kendall County, Texas",2862,1312,1550,48259,73240,15599,2200,16888,2215,32487,4415,44,21,stable,29.5,14,40384,0,0
TX,"Kerr County, Texas",7718,3243,4475,48265,43810,19403,4288,20616,4902,40019,9190,53.9,49,stable,46.2,43,50955,0,0
TX,"Kimble County, Texas",912,401,511,48267,40125,1637,572,1700,518,3337,1090,58.6,5,stable,59.2,5,4388,0,0
TX,"Kleberg County, Texas",7849,3836,4013,48273,38247,12628,3469,11798,3467,24426,6936,53.1,16,falling,36.8,11,31857,0,1
TX,"Lamar County, Texas",9076,3850,5226,48277,40748,19257,4479,20227,4937,39484,9416,78.4,50,stable,55.7,36,49440,0,0
TX,"Lamb County, Texas",3173,1511,1662,48279,39851,5326,1561,5166,1487,10492,3048,41,7,stable,31.1,5,13385,0,0
TX,"Lampasas County, Texas",2923,1347,1576,48281,49630,7621,1924,8352,1832,15973,3756,74.1,19,rising,66.5,17,20588,1,0
TX,"Lavaca County, Texas",1765,684,1081,48285,48677,7766,1495,8471,1382,16237,2877,55.3,17,rising,33.9,11,19836,1,0
TX,"Lee County, Texas",2374,1078,1296,48287,53902,6798,1244,6613,1521,13411,2765,44,9,stable,29.9,6,16898,0,0
TX,"Leon County, Texas",2322,990,1332,48289,49802,6688,1571,6745,1716,13433,3287,67.1,19,stable,62.7,17,17086,0,0
TX,"Liberty County, Texas",12548,5484,7064,48291,48729,27695,8434,27444,7858,55139,16292,84.3,64,stable,69.4,52,79654,0,0
TX,"Limestone County, Texas",5189,2600,2589,48293,37554,8344,3005,8787,2345,17131,5350,81.8,24,stable,57.9,17,23320,0,0
TX,"Live Oak County, Texas",1567,738,829,48297,50400,4064,886,4176,1158,8240,2044,49.4,9,stable,45.3,8,12229,0,0
TX,"Llano County, Texas",2841,1108,1733,48299,48259,7598,1502,8376,1594,15974,3096,53.4,24,stable,42.3,19,19796,0,0
TX,"Lubbock County, Texas",54155,24959,29196,48303,46075,115181,25530,121041,24799,236222,50329,53.2,139,stable,39.3,102,299453,0,0
TX,"Lynn County, Texas",1106,451,655,48305,39526,2195,677,2271,590,4466,1267,47.9,4,stable,45.7,3,5724,0,0
TX,"McCulloch County, Texas",1522,645,877,48307,40561,3306,740,3409,691,6715,1431,56,7,stable,40.8,6,8341,0,0
TX,"McLennan County, Texas",49881,22723,27158,48309,42687,93849,21068,102138,20131,195987,41199,66.1,164,stable,52.7,130,245671,0,0
TX,"Madison County, Texas",1938,925,1013,48313,39390,3731,850,4045,1023,7776,1873,53.7,8,stable,49.9,8,14065,0,0
TX,"Marion County, Texas",2264,742,1522,48315,34175,3761,1077,4209,1053,7970,2130,88.8,16,stable,80.3,14,10160,0,0
TX,"Matagorda County, Texas",7833,3539,4294,48321,40797,13769,4128,14174,4112,27943,8240,67.8,31,stable,48.2,21,36770,0,0
TX,"Maverick County, Texas",14872,6275,8597,48323,33747,18607,8661,18814,9758,37421,18419,36.7,17,stable,23.1,10,57706,0,0
TX,"Medina County, Texas",6656,2989,3667,48325,57338,18545,3569,19705,2956,38250,6525,45.6,24,stable,36.6,20,48417,0,0
TX,"Midland County, Texas",13238,5140,8098,48329,68806,59415,15246,59879,15709,119294,30955,54,71,stable,41.9,54,161077,0,0
TX,"Milam County, Texas",4159,1650,2509,48331,38929,9871,1918,10224,1877,20095,3795,65.2,23,stable,47.1,17,24513,0,0
TX,"Mills County, Texas",688,223,465,48333,43920,1887,288,2108,436,3995,724,45,4,stable,41.1,4,4900,0,0
TX,"Mitchell County, Texas",766,274,492,48335,49870,2548,788,2835,570,5383,1358,81.9,8,stable,58.5,6,9067,0,0
TX,"Montague County, Texas",2878,1274,1604,48337,46172,7160,2262,7429,2328,14589,4590,92.2,26,stable,69.9,20,19262,0,0
TX,"Montgomery County, Texas",59856,27146,32710,48339,68838,203475,43375,212877,39838,416352,83213,61.3,271,falling,47,201,537559,0,1
TX,"Moore County, Texas",4421,2081,2340,48341,49802,9007,2403,8437,2236,17444,4639,65.5,12,stable,46.1,8,22255,0,0
TX,"Morris County, Texas",2346,1000,1346,48343,39453,4990,1057,5323,1189,10313,2246,81.2,16,stable,70.5,14,12516,0,0
TX,"Nacogdoches County, Texas",14752,6761,7991,48347,39538,24195,6779,26244,7459,50439,14238,74.5,47,stable,59.7,37,65664,0,0
TX,"Navarro County, Texas",9794,4323,5471,48349,41505,18433,4787,18895,5267,37328,10054,62.3,35,stable,59.9,35,48323,0,0
TX,"Newton County, Texas",1798,877,921,48351,38144,5334,1736,5786,1018,11120,2754,65.9,13,stable,57.8,11,13986,0,0
TX,"Nolan County, Texas",3108,1410,1698,48353,37102,6040,1512,5859,1464,11899,2976,58.9,12,stable,58.9,11,15107,0,0
TX,"Nueces County, Texas",61965,27065,34900,48355,50337,135715,34184,144940,32292,280655,66476,51.7,184,stable,38.1,134,359715,0,0
TX,"Ochiltree County, Texas",1447,605,842,48357,51517,4160,1228,3919,1275,8079,2503,60.4,5,stable,56.4,5,10747,0,0
TX,"Orange County, Texas",12691,5723,6968,48361,49763,33263,7689,34818,6744,68081,14433,82.7,80,falling,61.9,59,84260,0,1
TX,"Palo Pinto County, Texas",5425,2473,2952,48363,39516,10384,3285,10729,3244,21113,6529,80.8,30,stable,58.4,22,27895,0,0
TX,"Panola County, Texas",3509,1196,2313,48365,50119,9312,2118,10013,2259,19325,4377,70.7,21,stable,56.6,17,23766,0,0
TX,"Parker County, Texas",11785,4602,7183,48367,67288,49667,9106,50821,9399,100488,18505,70.9,92,stable,56.9,71,126042,0,0
TX,"Pecos County, Texas",1643,728,915,48371,50305,5464,1551,5490,1261,10954,2812,40.7,6,falling,39.5,6,16203,0,1
TX,"Polk County, Texas",7279,3252,4027,48373,39662,16766,4163,16862,4307,33628,8470,99.4,67,stable,73.4,49,46972,0,0
TX,"Potter County, Texas",25466,10956,14510,48375,38159,42602,14415,45405,13402,88007,27817,73.3,83,stable,46.9,53,121802,0,0
TX,"Rains County, Texas",1206,514,692,48379,48448,4399,1209,4318,1044,8717,2253,87.5,15,stable,59.9,11,11161,0,0
TX,"Randall County, Texas",13076,5425,7651,48381,60972,53379,8330,56164,8041,109543,16371,52.8,68,stable,38.1,49,130269,0,0
TX,"Real County, Texas",541,242,299,48385,36523,1270,354,1232,409,2502,763,49.4,3,stable,56.7,4,3307,0,0
TX,"Red River County, Texas",2321,1053,1268,48387,31563,4706,1311,5175,1168,9881,2479,67,14,stable,51.5,11,12455,0,0
TX,"Reeves County, Texas",1895,825,1070,48389,43540,4368,860,4883,1253,9251,2113,35.8,5,stable,23.6,3,14732,0,0
TX,"Refugio County, Texas",1203,573,630,48391,44240,2911,661,2944,602,5855,1263,79.8,9,stable,69.5,8,7289,0,0
TX,"Robertson County, Texas",2841,1286,1555,48395,46501,6344,1812,6681,1499,13025,3311,58.2,13,stable,53.6,12,16659,0,0
TX,"Rockwall County, Texas",5310,2397,2913,48397,87524,36281,5253,38024,5226,74305,10479,49.2,34,stable,34.8,24,90861,0,0
TX,"Runnels County, Texas",2071,964,1107,48399,41526,4146,935,4227,928,8373,1863,61.1,10,stable,49.8,8,10551,0,0
TX,"Rusk County, Texas",8510,3598,4912,48401,46173,18852,5291,19359,5367,38211,10658,69.8,43,stable,51.6,33,53070,0,0
TX,"Sabine County, Texas",2840,1363,1477,48403,31307,3777,1276,4130,1174,7907,2450,71.3,16,stable,51.8,11,10368,0,0
TX,"San Augustine County, Texas",2105,978,1127,48405,28275,3122,964,3314,1087,6436,2051,73.8,11,stable,65.6,10,8473,0,0
TX,"San Jacinto County, Texas",5419,2160,3259,48407,43029,10737,2597,10586,2956,21323,5553,93,34,stable,75.2,28,27413,0,0
TX,"San Patricio County, Texas",9949,4153,5796,48409,52261,25544,6973,26358,6379,51902,13352,73.5,51,stable,55.7,39,67357,0,0
TX,"San Saba County, Texas",792,416,376,48411,39040,2429,513,2000,298,4429,811,60.9,6,stable,51.7,5,5901,0,0
TX,"Scurry County, Texas",1527,555,972,48415,56842,6772,1109,6466,1407,13238,2516,76.8,14,stable,53.2,10,17615,0,0
TX,"Shelby County, Texas",5553,2706,2847,48419,37756,9184,3301,9996,3064,19180,6365,73.4,23,stable,60,19,25402,0,0
TX,"Smith County, Texas",37048,16944,20104,48423,46929,82135,21568,91107,20424,173242,41992,67.3,166,stable,47.8,118,222936,0,0
TX,"Somervell County, Texas",1158,406,752,48425,51912,3218,875,3453,874,6671,1749,62,6,stable,44.5,5,8739,0,0
TX,"Starr County, Texas",22663,9955,12708,48427,26172,18529,11332,20213,12022,38742,23354,38.5,20,stable,25.4,13,63795,0,0
TX,"Stephens County, Texas",1751,749,1002,48429,43951,3528,915,3147,1191,6675,2106,83.7,11,stable,68.9,9,9440,0,0
TX,"Swisher County, Texas",1595,708,887,48437,37040,2853,616,3068,567,5921,1183,49.7,5,stable,36.7,4,7533,0,0
TX,"Tarrant County, Texas",283264,129036,154228,48439,58711,739469,189027,793135,177419,1532604,366446,60.2,903,falling,44.4,654,1982498,0,1
TX,"Taylor County, Texas",22395,9712,12683,48441,45396,51598,10570,56226,11336,107824,21906,60.3,85,stable,46.8,67,136051,0,0
TX,"Terry County, Texas",1756,726,1030,48445,37475,4344,1483,4434,1352,8778,2835,70.7,10,stable,52.9,8,12739,0,0
TX,"Titus County, Texas",6848,3136,3712,48449,44178,12377,3575,12702,3605,25079,7180,49.2,15,stable,45,14,32623,0,0
TX,"Tom Green County, Texas",16202,7037,9165,48451,46711,43247,10045,46420,10234,89667,20279,54.1,67,stable,41.5,52,118105,0,0
TX,"Travis County, Texas",180220,84267,95953,48453,61451,454074,106121,467836,86190,921910,192311,44.8,330,stable,32.6,230,1176558,0,0
TX,"Trinity County, Texas",2381,1166,1215,48455,34295,5485,1489,5866,1491,11351,2980,90.7,23,stable,74.7,19,14402,0,0
TX,"Tyler County, Texas",3159,1489,1670,48457,41360,7657,1696,8058,1627,15715,3323,72.8,23,stable,60.6,19,21347,0,0
TX,"Upshur County, Texas",5322,2251,3071,48459,46673,16130,3570,16157,3745,32287,7315,75.5,39,stable,57.6,29,40603,0,0
TX,"Upton County, Texas",657,278,379,48461,46131,1214,378,1316,439,2530,817,*,3 or fewer,stable,89.1,3,3651,0,0
TX,"Uvalde County, Texas",5248,2307,2941,48463,38568,9925,3035,10651,2984,20576,6019,38.1,12,stable,32.7,10,27245,0,0
TX,"Val Verde County, Texas",9738,4303,5435,48465,42174,17516,5036,17926,5882,35442,10918,35.4,17,stable,31.3,15,48988,0,0
TX,"Van Zandt County, Texas",8787,3991,4796,48467,44002,20005,5621,21102,5344,41107,10965,68.7,52,stable,57.5,42,53547,0,0
TX,"Victoria County, Texas",14531,6219,8312,48469,51758,35369,8179,36915,8540,72284,16719,57.6,56,stable,39.5,38,92382,0,0
TX,"Walker County, Texas",12642,5139,7503,48471,37666,19845,3706,24287,4320,44132,8026,68.5,43,stable,46.6,28,70699,0,0
TX,"Waller County, Texas",7505,3529,3976,48473,51348,17736,5186,17510,5160,35246,10346,53.7,21,stable,36.9,15,48656,0,0
TX,"Ward County, Texas",1831,905,926,48475,51345,4602,906,4370,1217,8972,2123,69.8,9,stable,57.7,7,11721,0,0
TX,"Washington County, Texas",4325,1895,2430,48477,51269,13553,3285,14529,2211,28082,5496,44.7,22,stable,35.4,17,34765,0,0
TX,"Webb County, Texas",82307,36856,45451,48479,38862,85837,40609,91945,42511,177782,83120,30.3,51,stable,20.7,35,269721,0,0
TX,"Wharton County, Texas",7178,3232,3946,48481,45176,15744,4348,16861,4001,32605,8349,49.7,25,stable,39.2,19,41486,0,0
TX,"Wheeler County, Texas",862,419,443,48483,52221,2148,673,2094,633,4242,1306,54,4,stable,59.1,4,5657,0,0
TX,"Wichita County, Texas",20712,8817,11895,48485,45543,45680,9621,51992,10046,97672,19667,74.9,106,stable,55.8,79,131705,0,0
TX,"Wilbarger County, Texas",2275,1155,1120,48487,41630,5337,1132,5308,1217,10645,2349,62.3,11,stable,43.5,7,13027,0,0
TX,"Willacy County, Texas",7604,3426,4178,48489,26495,6349,3273,6820,3070,13169,6343,40.4,9,stable,35.2,7,21903,0,0
TX,"Williamson County, Texas",35014,15936,19078,48491,73750,199404,30976,211551,27780,410955,58756,50.9,178,stable,35.5,122,508514,0,0
TX,"Wilson County, Texas",4783,2127,2656,48493,68100,19112,3384,19368,2993,38480,6377,43.7,22,stable,35.9,18,47520,0,0
TX,"Winkler County, Texas",1040,370,670,48495,55756,2829,879,2766,995,5595,1874,67.8,5,stable,49.1,4,8005,0,0
TX,"Wise County, Texas",7015,2646,4369,48497,56897,24533,5501,24716,5520,49249,11021,63.1,41,stable,55.2,35,62953,0,0
TX,"Wood County, Texas",6073,2621,3452,48499,45686,16976,3633,17291,4003,34267,7636,75.4,57,stable,57.9,44,43356,0,0
TX,"Yoakum County, Texas",979,308,671,48501,56153,3063,1048,3125,966,6188,2014,66.2,5,stable,52.8,4,8546,0,0
TX,"Young County, Texas",2751,1308,1443,48503,44693,6888,2148,7086,1934,13974,4082,74.2,20,stable,60.2,16,18270,0,0
UT,"Box Elder County, Utah",4779,2317,2462,49003,55038,23124,2303,23051,2112,46175,4415,20.4,10,stable,17.6,8,52097,0,0
UT,"Cache County, Utah",17713,8262,9451,49005,50497,51912,6142,53168,5493,105080,11635,15.8,12,stable,9.2,7,120783,0,0
UT,"Carbon County, Utah",3113,1350,1763,49007,46900,8742,1467,9307,1195,18049,2662,51.1,12,stable,34.5,8,20479,0,0
UT,"Davis County, Utah",24718,10960,13758,49011,71112,145687,14662,147007,12969,292694,27631,25,57,stable,17.2,38,336043,0,0
UT,"Duchesne County, Utah",2019,821,1198,49013,61133,8292,1519,8101,1535,16393,3054,50.2,8,stable,34.9,6,20862,0,0
UT,"Grand County, Utah",1740,877,863,49019,41312,3426,1354,3470,1073,6896,2427,61.9,7,stable,44.1,5,9516,0,0
UT,"Iron County, Utah",9727,4998,4729,49021,43855,18610,4636,19409,4043,38019,8679,29.5,11,stable,19.7,7,48368,0,0
UT,"Salt Lake County, Utah",131630,61427,70203,49035,62117,451726,84207,463806,71201,915532,155408,32.1,260,falling,22.1,177,1107314,0,1
UT,"Sanpete County, Utah",4043,1618,2425,49039,50323,10296,2052,11239,2099,21535,4151,29.3,8,stable,18.8,5,28778,0,0
UT,"Sevier County, Utah",2973,1222,1751,49041,46291,8616,1742,8384,1772,17000,3514,30.3,7,stable,21.3,5,20984,0,0
UT,"Summit County, Utah",3001,1546,1455,49043,91773,17112,2404,16860,2021,33972,4425,18.2,6,stable,14.4,4,39633,0,0
UT,"Tooele County, Utah",4339,1877,2462,49045,63552,27050,3351,27218,2768,54268,6119,40.2,16,stable,28.9,12,62952,0,0
UT,"Uintah County, Utah",3261,1530,1731,49047,66815,14957,2986,14652,2753,29609,5739,27.6,7,stable,24.3,6,37928,0,0
UT,"Utah County, Utah",71110,33388,37722,49049,62180,242176,32950,241635,31570,483811,64520,18.5,56,falling,12.4,37,575205,0,1
UT,"Wasatch County, Utah",2633,1199,1434,49051,66486,11263,2016,11400,1808,22663,3824,34.5,6,stable,23.1,4,29161,0,0
UT,"Washington County, Utah",21893,10244,11649,49053,50774,59249,13064,62096,12364,121345,25428,29.7,55,stable,22.5,41,155602,0,0
UT,"Weber County, Utah",30547,14446,16101,49057,56581,100971,16736,102594,15564,203565,32300,33.6,69,stable,25.4,51,243645,0,0
VA,"Accomack County, Virginia",6384,2475,3909,51001,39412,12900,2962,14094,2753,26994,5715,91.1,46,stable,76.7,38,32973,0,0
VA,"Albemarle County, Virginia",9714,4431,5283,51003,68449,44260,4170,49034,4068,93294,8238,41,49,stable,34.1,41,105703,0,0
VA,"Alleghany County, Virginia",2682,1184,1498,51005,45007,7093,703,7364,666,14457,1369,54.8,14,falling,61.3,16,15677,0,1
VA,"Amelia County, Virginia",1471,792,679,51007,56850,5483,971,5376,848,10859,1819,75.3,13,falling,65.5,11,12903,0,1
VA,"Amherst County, Virginia",4086,2099,1987,51009,47558,13171,2199,15012,1588,28183,3787,64.7,28,stable,51.8,23,31914,0,0
VA,"Appomattox County, Virginia",2668,1172,1496,51011,48823,6642,713,6903,879,13545,1592,75.5,15,stable,53.8,11,15414,0,0
VA,"Arlington County, Virginia",19996,9134,10862,51013,105763,97738,11574,101234,9734,198972,21308,37.2,61,stable,26.3,43,229164,0,0
VA,"Augusta County, Virginia",6694,2535,4159,51015,54558,30103,3876,32697,3556,62800,7432,51.7,53,stable,45.9,46,74314,0,0
VA,"Bath County, Virginia",347,185,162,51017,43646,1919,287,1971,344,3890,631,66,5,stable,41.6,4,4470,0,0
VA,"Bland County, Virginia",621,287,334,51021,45294,2578,245,2649,255,5227,500,83.5,8,stable,54.2,5,6561,0,0
VA,"Botetourt County, Virginia",2701,1248,1453,51023,60454,15366,893,15919,708,31285,1601,56.4,26,stable,41.9,20,33347,0,0
VA,"Brunswick County, Virginia",3298,1396,1902,51025,36919,6129,1200,7046,841,13175,2041,74.6,18,stable,46.5,11,16698,0,0
VA,"Buchanan County, Virginia",5841,2717,3124,51027,29679,9635,1386,10011,1414,19646,2800,53.9,18,stable,56.4,19,22776,0,0
VA,"Buckingham County, Virginia",2867,1283,1584,51029,40331,6196,1305,6470,1069,12666,2374,76.7,17,stable,54.2,11,17032,0,0
VA,"Campbell County, Virginia",7309,3096,4213,51031,47699,22926,3396,25433,2771,48359,6167,54.2,40,stable,47,35,55086,0,0
VA,"Caroline County, Virginia",3601,1521,2080,51033,59227,11117,1658,12880,1543,23997,3201,83.6,29,stable,64.6,21,29984,0,0
VA,"Carroll County, Virginia",5017,2237,2780,51035,35000,12746,2169,12772,2031,25518,4200,56.4,26,stable,55.4,26,29724,0,0
VA,"Charles City County, Virginia",933,379,554,51036,49563,3040,478,3211,366,6251,844,51.9,7,stable,55.6,7,7040,0,0
VA,"Charlotte County, Virginia",2589,1050,1539,51037,35079,5037,994,5142,1002,10179,1996,59.5,11,stable,42.1,8,12201,0,0
VA,"Chesterfield County, Virginia",24002,10156,13846,51041,72609,140593,15440,154425,14959,295018,30399,69.4,211,falling,47.6,143,335687,0,1
VA,"Clarke County, Virginia",1556,734,822,51043,71295,6011,910,6253,930,12264,1840,63.4,13,stable,64.9,13,14363,0,0
VA,"Craig County, Virginia",611,218,393,51045,44330,2140,345,2461,249,4601,594,58.9,5,stable,54,4,5211,0,0
VA,"Culpeper County, Virginia",4320,1806,2514,51047,66697,19760,3129,21227,2709,40987,5838,70.6,35,stable,54.3,26,49432,0,0
VA,"Cumberland County, Virginia",1996,1065,931,51049,39301,3922,1018,4156,763,8078,1781,64.8,9,stable,59.2,8,9719,0,0
VA,"Dickenson County, Virginia",3225,1513,1712,51051,33624,6679,911,6684,794,13363,1705,76.1,17,stable,71.6,16,15115,0,0
VA,"Dinwiddie County, Virginia",4061,1686,2375,51053,51397,12015,1568,12668,1434,24683,3002,70.9,24,stable,55,19,27852,0,0
VA,"Essex County, Virginia",1533,584,949,51057,42760,4431,704,5217,723,9648,1427,81.5,13,stable,61.8,10,11130,0,0
VA,"Fairfax County, Virginia",66762,29498,37264,51059,112552,484051,64076,509943,57197,993994,121273,40,390,stable,25.6,242,1142234,0,0
VA,"Fauquier County, Virginia",3762,1662,2100,51061,91609,29662,3417,31138,2792,60800,6209,48.7,37,stable,41.3,30,68782,0,0
VA,"Floyd County, Virginia",1551,803,748,51063,48005,6874,900,6930,731,13804,1631,47.5,10,stable,38.8,8,15651,0,0
VA,"Fluvanna County, Virginia",1618,666,952,51065,63938,10621,1184,11949,956,22570,2140,66.4,22,stable,39.4,13,26235,0,0
VA,"Franklin County, Virginia",8123,3695,4428,51067,46870,23707,3737,24950,3592,48657,7329,53.1,42,falling,43.4,34,56264,0,1
VA,"Frederick County, Virginia",5247,2162,3085,51069,69098,34801,4806,36267,4491,71068,9297,72.3,64,stable,52.6,46,83199,0,0
VA,"Giles County, Virginia",1891,851,1040,51071,46390,6871,1369,7376,1158,14247,2527,66.7,16,falling,64.1,16,16708,0,1
VA,"Gloucester County, Virginia",2735,1165,1570,51073,61121,15163,2448,16690,1875,31853,4323,88.7,42,stable,72.2,34,37143,0,0
VA,"Goochland County, Virginia",1163,520,643,51075,79330,9463,565,9654,727,19117,1292,66.3,20,stable,44.3,13,22253,0,0
VA,"Grayson County, Virginia",3244,1359,1885,51077,29942,6406,1063,6899,929,13305,1992,63.6,16,falling,62.7,16,16012,0,1
VA,"Greene County, Virginia",1853,751,1102,51079,61550,7787,1368,8152,1421,15939,2789,62.5,14,stable,44,9,19162,0,0
VA,"Greensville County, Virginia",1490,497,993,51081,38012,2862,304,3991,407,6853,711,81.5,12,stable,53.1,8,11885,0,0
VA,"Halifax County, Virginia",6675,3041,3634,51083,35240,13598,2820,15992,2384,29590,5204,58.7,32,stable,49.6,27,35125,0,0
VA,"Hanover County, Virginia",5976,2392,3584,51085,78645,45981,3228,48666,2723,94647,5951,80.7,94,stable,53,60,103227,0,0
VA,"Henrico County, Virginia",33914,14118,19796,51087,61934,131760,17728,151314,16043,283074,33771,57.2,190,stable,46.2,154,325155,0,0
VA,"Henry County, Virginia",9520,4167,5353,51089,35293,21245,3589,23490,3644,44735,7233,69.9,56,stable,54.7,44,51881,0,0
VA,"Isle of Wight County, Virginia",4137,1943,2194,51093,65741,15400,1844,16581,1445,31981,3289,63,29,falling,47.6,22,36314,0,1
VA,"James City County, Virginia",5648,2559,3089,51095,75710,30377,2719,33417,2569,63794,5288,42.8,45,stable,34,37,73147,0,0
VA,"King and Queen County, Virginia",949,470,479,51097,48292,3046,620,2929,511,5975,1131,80.1,8,stable,69,7,7158,0,0
VA,"King George County, Virginia",1366,522,844,51099,81688,11106,1084,11501,817,22607,1901,92.7,19,stable,55.4,12,25515,0,0
VA,"King William County, Virginia",1897,835,1062,51101,62031,7059,784,7410,785,14469,1569,60.8,11,stable,48.2,9,16269,0,0
VA,"Lancaster County, Virginia",1246,551,695,51103,50374,4506,709,5247,581,9753,1290,58.5,15,stable,50.8,13,10965,0,0
VA,"Lee County, Virginia",6027,2490,3537,51105,31086,9978,1920,10177,1706,20155,3626,82.4,27,falling,85.9,28,24742,0,1
VA,"Loudoun County, Virginia",14047,5850,8197,51107,123453,157541,14975,163902,12866,321443,27841,40.8,85,falling,34.2,67,375629,0,1
VA,"Louisa County, Virginia",3385,1584,1801,51109,57829,13771,2941,14541,2635,28312,5576,80,35,stable,59.7,26,34602,0,0
VA,"Lunenburg County, Virginia",2279,1015,1264,51111,39506,4355,870,5104,862,9459,1732,67.5,12,stable,57.7,11,12299,0,0
VA,"Madison County, Virginia",1613,725,888,51113,47736,5113,1182,5844,832,10957,2014,81.9,15,stable,47.1,9,13134,0,0
VA,"Mathews County, Virginia",613,274,339,51115,63845,3671,370,4387,333,8058,703,64.6,10,stable,47.6,9,8862,0,0
VA,"Mecklenburg County, Virginia",5975,2697,3278,51117,37356,11851,2293,14112,1936,25963,4229,75.2,39,stable,63.5,33,31081,0,0
VA,"Middlesex County, Virginia",982,462,520,51119,54654,4455,555,4995,345,9450,900,79.4,16,stable,60.1,13,10606,0,0
VA,"Montgomery County, Virginia",21707,11805,9902,51121,46663,45251,4418,43141,3090,88392,7508,54,43,stable,41.7,33,97653,0,0
VA,"Nelson County, Virginia",2159,1131,1028,51125,47118,6176,1016,6693,916,12869,1932,92,21,stable,62.3,15,14785,0,0
VA,"New Kent County, Virginia",1327,485,842,51127,73041,8949,665,8786,620,17735,1285,76.4,15,stable,68.1,13,20392,0,0
VA,"Northampton County, Virginia",2730,1193,1537,51131,35055,4367,1341,5069,1109,9436,2450,83.6,17,stable,73.6,15,12155,0,0
VA,"Northumberland County, Virginia",1352,537,815,51133,51885,5443,494,5866,501,11309,995,71.6,20,stable,52.3,14,12232,0,0
VA,"Nottoway County, Virginia",3444,1760,1684,51135,36284,6074,1133,6609,673,12683,1806,67.6,14,stable,52.4,11,15673,0,0
VA,"Orange County, Virginia",4105,1637,2468,51137,65166,14125,2432,15708,1808,29833,4240,77.8,37,stable,54.2,26,35385,0,0
VA,"Page County, Virginia",3880,1813,2067,51139,43895,9798,1753,10341,1756,20139,3509,66.1,22,stable,59.8,20,23726,0,0
VA,"Patrick County, Virginia",3818,1918,1900,51141,33982,7405,1494,7873,1265,15278,2759,51.2,15,stable,48.3,15,18045,0,0
VA,"Pittsylvania County, Virginia",9944,3897,6047,51143,41824,26329,3758,28133,3766,54462,7524,59.3,54,falling,55.1,50,62194,0,1
VA,"Powhatan County, Virginia",1252,476,776,51145,77896,11450,1149,12004,1018,23454,2167,65.8,21,stable,51.8,16,28031,0,0
VA,"Prince Edward County, Virginia",3883,1503,2380,51147,41697,9331,1508,10247,1213,19578,2721,53.3,13,stable,45.7,11,22952,0,0
VA,"Prince George County, Virginia",3370,1612,1758,51149,61857,14557,1641,15041,1285,29598,2926,65.2,24,stable,49,17,37862,0,0
VA,"Prince William County, Virginia",28739,12982,15757,51153,98657,181415,29623,192841,25170,374256,54793,48.4,133,stable,40.9,107,451721,0,0
VA,"Pulaski County, Virginia",4506,2063,2443,51155,47495,14622,1853,15274,1840,29896,3693,62.8,32,stable,59.1,30,34332,0,0
VA,"Rappahannock County, Virginia",733,323,410,51157,57210,3041,626,3185,561,6226,1187,65.2,7,stable,41.2,5,7378,0,0
VA,"Richmond County, Virginia",748,289,459,51159,47288,3021,350,3382,351,6403,701,72.9,9,stable,44.5,6,8908,0,0
VA,"Roanoke County, Virginia",7607,3482,4125,51161,60519,40502,3370,45602,2595,86104,5965,55.2,72,stable,42.7,56,94409,0,0
VA,"Rockbridge County, Virginia",3085,1379,1706,51163,48901,9518,1452,9803,1492,19321,2944,32,12,falling,37.1,14,22354,0,1
VA,"Rockingham County, Virginia",8471,3839,4632,51165,53744,32610,5364,35016,4421,67626,9785,49.4,51,stable,39.2,40,78593,0,0
VA,"Russell County, Virginia",5777,2322,3455,51167,35045,11370,2263,12398,1988,23768,4251,63.5,25,stable,65.4,26,27891,0,0
VA,"Scott County, Virginia",4406,1945,2461,51169,37240,9408,1489,9941,1111,19349,2600,72.1,25,stable,67.2,24,22126,0,0
VA,"Shenandoah County, Virginia",5138,2009,3129,51171,49406,17819,2682,19126,2645,36945,5327,67.4,41,stable,54.3,33,43190,0,0
VA,"Smyth County, Virginia",5815,2757,3058,51173,37983,12935,2252,14219,1792,27154,4044,92,42,stable,79.5,36,31470,0,0
VA,"Southampton County, Virginia",2649,1175,1474,51175,48962,7002,1249,7511,1110,14513,2359,63.8,16,stable,47.6,12,18109,0,0
VA,"Spotsylvania County, Virginia",10396,4565,5831,51177,78125,54453,7609,58090,6628,112543,14237,68.2,77,stable,52.9,57,130475,0,0
VA,"Stafford County, Virginia",6948,2928,4020,51179,97144,57845,6038,62285,4940,120130,10978,77.4,72,stable,53,46,142003,0,0
VA,"Surry County, Virginia",881,403,478,51181,53673,2798,551,3020,454,5818,1005,60.9,6,stable,53.7,5,6709,0,0
VA,"Sussex County, Virginia",1362,439,923,51183,39194,2766,202,3316,342,6082,544,90.7,14,stable,69.2,10,11715,0,0
VA,"Tazewell County, Virginia",7518,3186,4332,51185,37664,17568,3180,19194,2758,36762,5938,67.6,42,stable,64.5,40,42899,0,0
VA,"Warren County, Virginia",3696,1533,2163,51187,61454,16779,2310,16876,2147,33655,4457,72.1,31,stable,56.7,24,39083,0,0
VA,"Washington County, Virginia",6845,3161,3684,51191,43310,23508,3123,24471,3018,47979,6141,75.6,60,falling,61.9,49,54591,0,1
VA,"Westmoreland County, Virginia",2323,1045,1278,51193,47911,6984,1480,7735,1204,14719,2684,74.7,22,stable,52.3,15,17629,0,0
VA,"Wise County, Virginia",8414,3646,4768,51195,37407,16419,2526,17017,2358,33436,4884,84.3,42,stable,75,36,39718,0,0
VA,"Wythe County, Virginia",4356,2050,2306,51197,41360,12470,1769,12508,2170,24978,3939,74.7,31,stable,48.2,21,29119,0,0
VA,"York County, Virginia",4198,1815,2383,51199,81749,28042,2094,31490,1852,59532,3946,48.4,33,stable,37,25,67837,0,0
VA,"Alexandria city, Virginia",12359,4903,7456,51510,89134,58340,11458,66921,9509,125261,20967,28.8,34,stable,26.4,33,153511,0,0
VA,"Bristol city, Virginia",3496,1410,2086,51520,35368,6543,1492,8273,1059,14816,2551,54.6,14,stable,76.6,20,17141,0,0
VA,"Buena Vista city, Virginia",1755,529,1226,51530,29097,2489,551,2995,555,5484,1106,107.3,8,stable,84.3,6,6618,0,0
VA,"Charlottesville city, Virginia",10995,5182,5813,51540,49775,19142,2389,20847,2328,39989,4717,114.7,38,rising,55.1,19,46597,1,0
VA,"Chesapeake city, Virginia",21734,8627,13107,51550,68620,92540,9502,106793,9602,199333,19104,71.6,149,stable,51.8,105,235429,0,0
VA,"Colonial Heights city, Virginia",1974,837,1137,51570,50304,7065,947,8246,1010,15311,1957,69.5,17,stable,47.2,12,17820,0,0
VA,"Covington city, Virginia",1437,587,850,51580,34746,2384,431,2323,418,4707,849,167,13,stable,66.2,5,5658,0,0
VA,"Danville city, Virginia",9629,4000,5629,51590,32315,16255,2690,19869,2495,36124,5185,92.4,57,stable,56,35,42082,0,0
VA,"Emporia city, Virginia",1907,862,1045,51595,28601,1825,684,2492,456,4317,1140,56.2,4,rising,64.3,5,5496,1,0
VA,"Fairfax city, Virginia",1593,831,762,51600,105297,9803,1455,10508,1132,20311,2587,26.5,7,stable,40.3,11,24013,0,0
VA,"Falls Church city, Virginia",361,124,237,51610,120522,6120,166,6616,309,12736,475,44.8,5,stable,25.1,3,13892,0,0
VA,"Franklin city, Virginia",1762,962,800,51620,32399,3109,605,3958,655,7067,1260,82.8,9,stable,47.6,5,8490,0,0
VA,"Fredericksburg city, Virginia",4108,1727,2381,51630,51762,10932,1700,12554,1962,23486,3662,95.1,20,stable,49.1,11,28118,0,0
VA,"Galax city, Virginia",1766,913,853,51640,30604,2680,540,2962,404,5642,944,80.2,8,stable,36.8,4,6914,0,0
VA,"Hampton city, Virginia",20187,8590,11597,51650,49190,53054,8905,62299,7512,115353,16417,76.8,110,stable,56,80,136454,0,0
VA,"Harrisonburg city, Virginia",14326,6628,7698,51660,38750,20221,3794,22806,3851,43027,7645,91.2,29,stable,48.2,16,52538,0,0
VA,"Hopewell city, Virginia",4165,1792,2373,51670,39064,8816,1592,10088,1452,18904,3044,89.5,24,stable,66.6,18,22378,0,0
VA,"Lynchburg city, Virginia",16775,7243,9532,51680,39589,31269,4648,36055,4663,67324,9311,75.9,61,stable,52.8,44,79812,0,0
VA,"Manassas city, Virginia",3945,1572,2373,51683,72890,16098,4164,16731,3696,32829,7860,55.1,14,stable,38.8,10,41764,0,0
VA,"Manassas Park city, Virginia",1232,646,586,51685,73528,5839,2304,5675,1721,11514,4025,*,3 or fewer,stable,42,4,15726,0,0
VA,"Martinsville city, Virginia",3105,1269,1836,51690,29587,4866,1064,6285,1056,11151,2120,70.8,14,stable,81.9,17,13645,0,0
VA,"Newport News city, Virginia",26984,11787,15197,51700,50077,68381,12028,81163,10640,149544,22668,75.2,125,stable,57.3,94,182385,0,0
VA,"Norfolk city, Virginia",46288,21633,24655,51710,44480,87440,19429,96562,15844,184002,35273,75.6,152,stable,53.6,108,246393,0,0
VA,"Petersburg city, Virginia",8795,3584,5211,51730,31798,11320,2846,14554,2519,25874,5365,113.1,45,stable,68.9,27,32477,0,0
VA,"Poquoson city, Virginia",502,134,368,51735,83735,5482,338,5865,252,11347,590,50.2,7,stable,44.2,7,12059,0,0
VA,"Portsmouth city, Virginia",17000,6563,10437,51740,45676,37167,6080,42515,6536,79682,12616,78.3,81,stable,60.3,63,96201,0,0
VA,"Radford city, Virginia",5497,2608,2889,51750,29912,7317,805,8094,670,15411,1475,87.3,9,stable,67.2,7,17403,0,0
VA,"Richmond city, Virginia",51828,22792,29036,51760,40758,79997,19858,95434,15861,175431,35719,76.1,151,stable,57.3,115,220289,0,0
VA,"Roanoke city, Virginia",20514,8945,11569,51770,39930,38410,8301,43908,6823,82318,15124,95.5,110,stable,65.3,75,99897,0,0
VA,"Salem city, Virginia",2578,1082,1496,51775,50068,10218,1258,11713,1306,21931,2564,71.5,24,stable,51,17,25432,0,0
VA,"Staunton city, Virginia",4052,1677,2375,51790,40842,9175,1415,11390,1665,20565,3080,96.8,35,stable,54.3,20,24416,0,0
VA,"Suffolk city, Virginia",9835,4190,5645,51800,65499,35051,4543,40616,3608,75667,8151,68.3,59,falling,48.2,41,88161,0,1
VA,"Virginia Beach city, Virginia",36267,15055,21212,51810,66634,177592,22265,203264,19818,380856,42083,67.5,279,stable,46.8,191,452745,0,0
VA,"Waynesboro city, Virginia",3796,1496,2300,51820,45643,8151,1881,9559,1418,17710,3299,88.3,24,stable,50.9,14,21491,0,0
VA,"Williamsburg city, Virginia",2401,1108,1293,51830,48639,5859,694,7727,292,13586,986,127.9,19,stable,28.7,4,15052,0,0
VA,"Winchester city, Virginia",4200,1784,2416,51840,45363,10765,2501,11474,2166,22239,4667,57.1,17,falling,51.9,16,27284,0,1
VT,"Addison County, Vermont",3124,1498,1626,50001,59688,16935,1355,17583,841,34518,2196,65.6,30,falling,45.6,20,37035,0,1
VT,"Bennington County, Vermont",4735,2226,2509,50003,49573,16484,1227,17710,683,34194,1910,64.3,36,stable,46,26,36317,0,0
VT,"Caledonia County, Vermont",3733,1458,2275,50005,45323,13745,1374,14869,633,28614,2007,74.8,29,stable,57.2,23,30780,0,0
VT,"Chittenden County, Vermont",17045,7513,9532,50007,65350,73192,4265,78128,2958,151320,7223,65.5,104,stable,42.8,67,161382,0,0
VT,"Essex County, Vermont",929,412,517,50009,36599,2775,336,2882,214,5657,550,77.6,8,stable,48.7,5,6163,0,0
VT,"Franklin County, Vermont",4147,1893,2254,50011,58199,21866,1751,23348,910,45214,2661,79.6,41,stable,59,29,48799,0,0
VT,"Grand Isle County, Vermont",598,275,323,50013,62608,3238,181,3398,135,6636,316,89.1,7,stable,44.6,4,6861,0,0
VT,"Lamoille County, Vermont",2887,1126,1761,50015,50939,11169,1231,11606,926,22775,2157,66.1,19,stable,43.9,13,25235,0,0
VT,"Orange County, Vermont",3498,1601,1897,50017,53869,13236,1091,13853,662,27089,1753,67.2,24,stable,56.9,21,28899,0,0
VT,"Orleans County, Vermont",4070,1866,2204,50019,42831,11937,1229,12539,798,24476,2027,59.4,23,stable,48.5,19,27100,0,0
VT,"Rutland County, Vermont",7276,3507,3769,50021,49372,27003,2340,29043,1462,56046,3802,72.6,63,falling,51.3,44,59736,0,1
VT,"Washington County, Vermont",5729,2530,3199,50023,58788,27153,1838,28500,1139,55653,2977,61,46,stable,47.6,36,58612,0,0
VT,"Windham County, Vermont",5421,2361,3060,50025,51045,19827,1631,20905,1054,40732,2685,58.9,36,stable,41.8,25,43386,0,0
VT,"Windsor County, Vermont",6041,2725,3316,50027,52965,24618,2209,26757,1685,51375,3894,67.4,57,stable,45.7,39,55737,0,0
WA,"Adams County, Washington",4019,1948,2071,53001,46564,7244,2345,7393,1866,14637,4211,37,6,stable,29.9,5,19254,0,0
WA,"Asotin County, Washington",3301,1474,1827,53003,44394,9147,1338,10096,1276,19243,2614,66.8,21,stable,51.2,17,22105,0,0
WA,"Benton County, Washington",26013,11805,14208,53005,60251,78627,12759,81892,10110,160519,22869,59.9,109,stable,44.8,81,190309,0,0
WA,"Chelan County, Washington",10466,4799,5667,53007,51837,30164,6518,31017,5995,61181,12513,49.8,47,stable,38.3,36,75644,0,0
WA,"Clallam County, Washington",10682,4864,5818,53009,47253,30189,5059,32350,3823,62539,8882,69.6,90,stable,51.2,66,73486,0,0
WA,"Clark County, Washington",49314,21861,27453,53011,60756,191398,26615,202078,21962,393476,48577,62.1,266,stable,48,206,459495,0,0
WA,"Columbia County, Washington",690,357,333,53013,38581,1801,152,1772,204,3573,356,62.2,4,stable,48.6,4,3944,0,0
WA,"Cowlitz County, Washington",17609,8049,9560,53015,47452,43804,6096,46637,4793,90441,10889,66.3,88,stable,53.9,71,103468,0,0
WA,"Douglas County, Washington",5835,2677,3158,53017,53636,16380,3439,16466,3183,32846,6622,42,19,stable,38.6,17,40534,0,0
WA,"Ferry County, Washington",1659,906,753,53019,38125,3358,584,3156,482,6514,1066,46,6,stable,37.8,4,7582,0,0
WA,"Franklin County, Washington",15406,7067,8339,53021,56980,34404,8573,33744,7554,68148,16127,52.7,27,stable,38.5,19,88807,0,0
WA,"Grant County, Washington",16295,7498,8797,53025,48714,36748,9464,37816,7528,74564,16992,57.1,49,stable,44.5,39,93259,0,0
WA,"Grays Harbor County, Washington",12357,5580,6777,53027,43538,28006,6113,29766,4657,57772,10770,81.9,81,falling,62.6,61,71122,0,1
WA,"Island County, Washington",7430,3115,4315,53029,58815,32026,3558,35824,2956,67850,6514,48.2,56,falling,32.4,38,80593,0,1
WA,"Jefferson County, Washington",3508,1500,2008,53031,49279,12750,1462,13636,1516,26386,2978,55.7,34,falling,43.5,27,30466,0,1
WA,"King County, Washington",226204,105541,120663,53033,75302,902948,109785,931439,87970,1834387,197755,51.8,972,falling,36.4,681,2117125,0,1
WA,"Kitsap County, Washington",26349,11851,14498,53035,62941,105860,12172,114564,9019,220424,21191,60.5,173,falling,43,123,260131,0,1
WA,"Kittitas County, Washington",8804,3868,4936,53037,46458,18041,2888,18507,2461,36548,5349,47.4,20,stable,44.4,18,43269,0,0
WA,"Klickitat County, Washington",3150,1141,2009,53039,48319,8931,1312,9304,1230,18235,2542,47.6,15,stable,45.1,14,21026,0,0
WA,"Lewis County, Washington",12126,5448,6678,53041,44100,31708,5503,33362,4101,65070,9604,61.9,65,stable,52.8,56,75882,0,0
WA,"Lincoln County, Washington",1562,720,842,53043,46069,4580,558,4572,524,9152,1082,60.9,10,stable,49.6,9,10321,0,0
WA,"Mason County, Washington",10166,5632,4534,53045,50406,24762,5776,25128,3666,49890,9442,75.9,69,falling,54.2,48,61023,0,1
WA,"Okanogan County, Washington",8646,4399,4247,53047,40730,16363,4244,17129,3081,33492,7325,62.8,36,stable,47.1,26,41516,0,0
WA,"Pacific County, Washington",3918,1788,2130,53049,37684,8472,1709,8944,1273,17416,2982,62,24,stable,55.9,22,20848,0,0
WA,"Pend Oreille County, Washington",2753,1293,1460,53051,40599,5656,956,5504,741,11160,1697,74.9,15,stable,60.6,12,13088,0,0
WA,"Pierce County, Washington",102233,45865,56368,53053,59953,342382,49080,366397,41647,708779,90727,76.1,590,falling,51.6,396,843954,0,1
WA,"San Juan County, Washington",1823,731,1092,53055,55960,6533,1092,7315,961,13848,2053,34.8,11,falling,23.9,7,16252,0,1
WA,"Skagit County, Washington",18815,8499,10316,53057,54129,49647,8556,52627,7262,102274,15818,63.1,98,falling,47.1,74,121846,0,1
WA,"Skamania County, Washington",1526,627,899,53059,52374,5000,634,4888,683,9888,1317,47.7,7,stable,43.8,6,11339,0,0
WA,"Snohomish County, Washington",74826,33579,41247,53061,70722,324114,43247,333818,35930,657932,79177,64.1,433,falling,45,300,772501,0,1
WA,"Spokane County, Washington",74110,35552,38558,53063,50079,203353,27783,218074,22614,421427,50397,59.8,313,stable,47.2,245,490945,0,0
WA,"Stevens County, Washington",7753,3573,4180,53065,41978,18707,3059,18919,2601,37626,5660,58.7,38,stable,42.7,27,43791,0,0
WA,"Thurston County, Washington",32101,14506,17595,53067,61677,109470,14498,121226,11366,230696,25864,63.8,180,falling,48.1,135,269536,0,1
WA,"Walla Walla County, Washington",9535,4153,5382,53071,47946,23430,3994,25935,3006,49365,7000,53.4,37,stable,41.6,30,60338,0,0
WA,"Whatcom County, Washington",32328,14556,17772,53073,53145,88692,12829,92693,11182,181385,24011,59.8,133,stable,42.2,95,212284,0,0
WA,"Whitman County, Washington",12580,6698,5882,53075,36631,21484,2147,21226,1645,42710,3792,41.7,15,stable,31.7,11,48177,0,0
WA,"Yakima County, Washington",51694,23973,27721,53077,44749,94384,27518,100082,22537,194466,50055,57.6,137,stable,47.2,113,248830,0,0
WI,"Adams County, Wisconsin",2704,1437,1267,55001,43640,8852,1047,8731,623,17583,1670,85.7,32,stable,72.7,27,20148,0,0
WI,"Ashland County, Wisconsin",2398,1017,1381,55003,39381,7023,857,7210,668,14233,1525,71.4,15,stable,64.2,13,15843,0,0
WI,"Barron County, Wisconsin",5640,2618,3022,55005,45714,20513,2246,20742,1595,41255,3841,58.9,38,stable,47.1,31,45563,0,0
WI,"Bayfield County, Wisconsin",1719,772,947,55007,46665,6840,806,6659,621,13499,1427,54.9,14,stable,48.6,12,14977,0,0
WI,"Brown County, Wisconsin",28969,12381,16588,55009,53527,112051,11974,118922,8628,230973,20602,57.9,149,stable,41.6,107,258718,0,0
WI,"Buffalo County, Wisconsin",1500,716,784,55011,50196,6087,610,6131,404,12218,1014,52.4,10,stable,52.6,10,13192,0,0
WI,"Burnett County, Wisconsin",2371,1171,1200,55013,41135,7002,752,6922,526,13924,1278,75.7,20,stable,63.1,17,15159,0,0
WI,"Calumet County, Wisconsin",3434,1377,2057,55015,67427,23675,1135,23917,764,47592,1899,53.3,27,falling,37.3,18,49762,0,1
WI,"Chippewa County, Wisconsin",6081,2915,3166,55017,52109,27969,2835,28154,2015,56123,4850,65.8,50,stable,48.3,37,63531,0,0
WI,"Clark County, Wisconsin",5504,2419,3085,55019,45048,12917,4257,13163,3681,26080,7938,52.3,22,stable,33.5,14,34445,0,0
WI,"Columbia County, Wisconsin",4844,2124,2720,55021,59769,25586,2066,25850,1724,51436,3790,64.3,45,stable,45.7,32,56743,0,0
WI,"Crawford County, Wisconsin",2023,869,1154,55023,44459,7223,724,7359,512,14582,1236,62.4,16,stable,45.8,12,16391,0,0
WI,"Dane County, Wisconsin",64062,28989,35073,55025,62865,233187,17151,242391,13428,475578,30579,54.3,245,stable,38.8,174,523643,0,0
WI,"Dodge County, Wisconsin",7658,3436,4222,55027,53783,39787,2809,39114,2204,78901,5013,58.6,65,stable,45.6,51,88502,0,0
WI,"Door County, Wisconsin",2766,1255,1511,55029,51928,12515,989,13126,792,25641,1781,53.8,27,stable,41.2,21,27554,0,0
WI,"Douglas County, Wisconsin",6713,3156,3557,55031,47095,19364,2166,19725,1950,39089,4116,58.1,31,stable,57.9,31,43601,0,0
WI,"Dunn County, Wisconsin",6140,2632,3508,55033,49788,20042,2083,20090,1603,40132,3686,45.4,21,stable,34.5,16,44497,0,0
WI,"Eau Claire County, Wisconsin",14862,6739,8123,55035,49513,44541,4833,47417,3798,91958,8631,57.1,61,stable,43.1,46,102105,0,0
WI,"Florence County, Wisconsin",409,160,249,55037,48643,2117,212,1921,168,4038,380,66.5,5,stable,51.4,4,4464,0,0
WI,"Fond du Lac County, Wisconsin",9071,3932,5139,55039,55473,45814,3550,47977,2919,93791,6469,60.7,76,stable,41.8,53,101973,0,0
WI,"Forest County, Wisconsin",1505,729,776,55041,40636,3838,706,3760,647,7598,1353,94.7,14,stable,48.8,7,9057,0,0
WI,"Grant County, Wisconsin",7318,3707,3611,55043,49067,23530,2547,22298,2000,45828,4547,51.5,33,stable,39.7,26,52250,0,0
WI,"Green County, Wisconsin",3253,1413,1840,55045,56219,16939,1262,17476,1020,34415,2282,58.6,27,stable,41.2,19,37186,0,0
WI,"Green Lake County, Wisconsin",2274,1143,1131,55047,46780,8270,1201,8267,1029,16537,2230,53.7,15,stable,40.7,12,18856,0,0
WI,"Iowa County, Wisconsin",2448,1154,1294,55049,55188,10926,886,11228,549,22154,1435,56,17,stable,37.2,11,23813,0,0
WI,"Iron County, Wisconsin",653,277,376,55051,42543,2598,286,2655,263,5253,549,79.3,9,stable,50.5,6,5794,0,0
WI,"Jackson County, Wisconsin",2810,1234,1576,55053,47851,8752,1133,8570,882,17322,2015,69,19,stable,50.7,14,20554,0,0
WI,"Jefferson County, Wisconsin",8597,3917,4680,55055,56877,38604,3136,39813,2311,78417,5447,56.2,52,stable,38.7,36,84559,0,0
WI,"Juneau County, Wisconsin",3567,1754,1813,55057,44961,11261,1407,11465,855,22726,2262,67.5,26,stable,54.7,21,26224,0,0
WI,"Kenosha County, Wisconsin",24823,11271,13552,55059,54918,72812,8862,77613,6584,150425,15446,73.1,120,stable,52.7,87,168437,0,0
WI,"Kewaunee County, Wisconsin",1800,762,1038,55061,56863,9778,576,9635,354,19413,930,50.7,14,stable,33.2,9,20366,0,0
WI,"La Crosse County, Wisconsin",16616,7106,9510,55063,50539,52456,4225,55751,3356,108207,7581,60.4,77,stable,43.1,55,118212,0,0
WI,"Lafayette County, Wisconsin",1800,809,991,55065,51445,7492,966,7453,824,14945,1790,47.5,11,stable,35.5,8,16829,0,0
WI,"Langlade County, Wisconsin",3063,1523,1540,55067,41775,8727,909,8809,860,17536,1769,64.2,20,stable,50.4,16,19223,0,0
WI,"Lincoln County, Wisconsin",2800,1249,1551,55069,49721,12683,1144,13038,864,25721,2008,64.1,27,stable,47.4,20,27980,0,0
WI,"Manitowoc County, Wisconsin",7957,3304,4653,55071,48398,37344,2605,38095,1898,75439,4503,52.2,59,stable,38.4,44,79806,0,0
WI,"Marathon County, Wisconsin",14095,6537,7558,55073,54083,61200,6094,62787,3920,123987,10014,48.8,78,stable,37.7,61,135868,0,0
WI,"Marinette County, Wisconsin",5168,2229,2939,55075,43425,18931,1561,19019,1227,37950,2788,72.3,47,falling,50.2,33,40884,0,1
WI,"Marquette County, Wisconsin",2069,994,1075,55077,46242,6877,704,6849,551,13726,1255,76.3,19,stable,59.2,15,15075,0,0
WI,"Milwaukee County, Wisconsin",201124,91053,110071,55079,43873,396071,59798,448635,42222,844706,102020,71.1,658,stable,52,484,957735,0,0
WI,"Monroe County, Wisconsin",6676,3011,3665,55081,50694,19450,2657,20110,2060,39560,4717,77.3,41,stable,52.2,28,45549,0,0
WI,"Oconto County, Wisconsin",3466,1682,1784,55083,52765,17497,1497,17166,1051,34663,2548,76.5,39,stable,47.2,24,37435,0,0
WI,"Oneida County, Wisconsin",3632,1646,1986,55085,46516,16064,1601,16488,970,32552,2571,78.2,48,stable,53.2,33,35567,0,0
WI,"Outagamie County, Wisconsin",15723,7230,8493,55087,58765,82663,6476,85176,4627,167839,11103,54.8,99,stable,39.6,72,183245,0,0
WI,"Ozaukee County, Wisconsin",4467,1716,2751,55089,76433,40545,2024,42586,1561,83131,3585,49.4,55,stable,32.5,37,87850,0,0
WI,"Pepin County, Wisconsin",947,403,544,55091,49516,3293,370,3209,382,6502,752,53.4,6,stable,38.1,4,7290,0,0
WI,"Pierce County, Wisconsin",4615,2047,2568,55093,61611,18519,1653,19153,1225,37672,2878,37.6,15,falling,36.7,14,40889,0,1
WI,"Polk County, Wisconsin",4407,1978,2429,55095,50714,19563,2138,19648,1782,39211,3920,52.3,31,stable,44.7,27,43441,0,0
WI,"Portage County, Wisconsin",10095,5009,5086,55097,51613,32286,2817,33287,1724,65573,4541,54.3,42,stable,38.6,30,70408,0,0
WI,"Price County, Wisconsin",1860,888,972,55099,43137,6398,455,6296,455,12694,910,58,14,stable,47,11,13645,0,0
WI,"Racine County, Wisconsin",23768,9979,13789,55101,55584,83220,10012,89921,7615,173141,17627,69.5,153,stable,47.5,104,195080,0,0
WI,"Richland County, Wisconsin",2609,1271,1338,55103,44810,7966,906,8038,695,16004,1601,57.7,14,stable,43.6,11,17495,0,0
WI,"Rock County, Wisconsin",23498,10753,12745,55105,50324,69942,8250,75101,6048,145043,14298,74.9,139,stable,54.5,101,161448,0,0
WI,"Rusk County, Wisconsin",2252,1121,1131,55107,39194,6262,886,6450,621,12712,1507,76,18,stable,55.7,13,14124,0,0
WI,"St. Croix County, Wisconsin",5502,2468,3034,55109,70886,39513,2938,40514,2392,80027,5330,45.4,35,rising,37.9,29,87513,1,0
WI,"Sauk County, Wisconsin",7656,3355,4301,55111,51055,28199,2991,28541,2533,56740,5524,57.3,44,stable,50,39,63642,0,0
WI,"Sawyer County, Wisconsin",2673,1195,1478,55113,41665,7117,1018,7312,728,14429,1746,67.3,18,falling,54.9,15,16376,0,1
WI,"Shawano County, Wisconsin",4451,1998,2453,55115,47861,18453,2016,18780,1709,37233,3725,55,33,stable,44.9,27,41304,0,0
WI,"Sheboygan County, Wisconsin",10348,4731,5617,55117,53713,51687,4580,53467,3184,105154,7764,60.6,84,stable,45.2,63,115569,0,0
WI,"Taylor County, Wisconsin",2527,1150,1377,55119,45420,9110,1300,9115,813,18225,2113,47.4,13,stable,29.4,8,20455,0,0
WI,"Trempealeau County, Wisconsin",3078,1355,1723,55121,51077,13246,1379,13470,889,26716,2268,57.9,21,stable,47.1,18,29550,0,0
WI,"Vernon County, Wisconsin",4757,2125,2632,55123,47675,12288,2659,12561,2463,24849,5122,55,23,stable,43.5,19,30506,0,0
WI,"Vilas County, Wisconsin",3047,1365,1682,55125,41061,9450,1164,9854,710,19304,1874,66.9,28,rising,48.1,21,21387,1,0
WI,"Walworth County, Wisconsin",13499,5855,7644,55127,53445,45658,5450,47291,3835,92949,9285,64,75,stable,46.2,54,102804,0,0
WI,"Washburn County, Wisconsin",2022,911,1111,55129,42368,6874,832,7253,554,14127,1386,71.5,19,stable,53.8,14,15552,0,0
WI,"Washington County, Wisconsin",7375,2950,4425,55131,69237,62004,3345,63727,2899,125731,6244,57.3,89,stable,39.5,61,133674,0,0
WI,"Waukesha County, Wisconsin",20433,8852,11581,55133,76545,182973,9129,191505,7700,374478,16829,54.6,262,stable,39.8,191,396488,0,0
WI,"Waupaca County, Wisconsin",5232,2328,2904,55135,51994,23435,2093,23613,1501,47048,3594,64.7,48,stable,50.4,38,51945,0,0
WI,"Waushara County, Wisconsin",2385,1092,1293,55137,45166,10355,1332,10471,1011,20826,2343,72,28,stable,50.7,20,24033,0,0
WI,"Winnebago County, Wisconsin",19209,8291,10918,55139,52018,74590,6032,78495,4794,153085,10826,62.2,117,stable,44.7,85,169546,0,0
WI,"Wood County, Wisconsin",7996,3644,4352,55141,48961,33602,2741,35148,1845,68750,4586,57.4,58,stable,40.3,42,73435,0,0
WV,"Barbour County, West Virginia",3482,1682,1800,54001,37066,6927,1173,7434,1040,14361,2213,58.8,13,stable,42.9,9,16704,0,0
WV,"Berkeley County, West Virginia",15235,6801,8434,54003,55239,47309,5793,49115,5848,96424,11641,83.7,92,stable,65.1,69,111901,0,0
WV,"Boone County, West Virginia",5529,2643,2886,54005,39958,10532,1330,10908,1114,21440,2444,111.8,34,stable,81.5,25,23372,0,0
WV,"Braxton County, West Virginia",2941,1496,1445,54007,32750,6032,961,6145,971,12177,1932,72.4,16,stable,61.4,13,14415,0,0
WV,"Brooke County, West Virginia",2960,1290,1670,54009,46215,10230,1236,11001,1006,21231,2242,64.7,24,stable,54.5,21,23350,0,0
WV,"Cabell County, West Virginia",20110,8964,11146,54011,38344,40407,5898,44087,5004,84494,10902,89.9,109,stable,64.3,79,96844,0,0
WV,"Calhoun County, West Virginia",1314,569,745,54013,35568,3209,567,3072,686,6281,1253,90.9,11,stable,79,9,7470,0,0
WV,"Clay County, West Virginia",2530,1119,1411,54015,31325,3955,603,4026,498,7981,1101,99.8,13,stable,70.6,9,8910,0,0
WV,"Doddridge County, West Virginia",1190,457,733,54017,39974,3243,662,3175,536,6418,1198,40,4,stable,52.3,6,8176,0,0
WV,"Fayette County, West Virginia",8683,3956,4727,54019,36293,18691,3142,19390,2986,38081,6128,87.6,56,stable,73.5,47,44997,0,0
WV,"Gilmer County, West Virginia",1781,977,804,54021,37536,3146,508,2909,501,6055,1009,46.8,5,stable,47.5,5,8518,0,0
WV,"Grant County, West Virginia",1791,882,909,54023,39088,5242,612,5419,432,10661,1044,52.7,9,stable,40.4,7,11766,0,0
WV,"Greenbrier County, West Virginia",6530,2939,3591,54025,39746,14842,2261,15908,2024,30750,4285,67.8,38,stable,48.6,26,35516,0,0
WV,"Hampshire County, West Virginia",4721,2317,2404,54027,27995,9515,2254,9704,1538,19219,3792,83.8,27,stable,63.5,20,23353,0,0
WV,"Hancock County, West Virginia",4835,2034,2801,54029,39959,13027,1533,13682,1731,26709,3264,78.9,36,stable,62.4,29,29815,0,0
WV,"Hardy County, West Virginia",1863,773,1090,54031,40303,6160,846,6168,704,12328,1550,68.8,13,stable,39.4,8,13852,0,0
WV,"Harrison County, West Virginia",11072,4992,6080,54033,43987,29328,4163,31103,3815,60431,7978,87.3,82,stable,61.5,58,68714,0,0
WV,"Jackson County, West Virginia",4743,2268,2475,54035,41314,13027,1410,13302,1341,26329,2751,74.3,31,stable,63.7,26,29237,0,0
WV,"Jefferson County, West Virginia",6222,2521,3701,54037,66677,23866,3089,25503,2490,49369,5579,71,41,stable,51.6,30,56482,0,0
WV,"Kanawha County, West Virginia",29703,13258,16445,54039,45882,80160,10691,88818,9372,168978,20063,87.3,231,stable,64.5,170,188332,0,0
WV,"Lewis County, West Virginia",3357,1583,1774,54041,37849,7138,1004,7214,992,14352,1996,100.1,25,stable,64.6,15,16448,0,0
WV,"Lincoln County, West Virginia",5870,2758,3112,54043,35800,9453,1235,9667,1145,19120,2380,111.5,32,falling,77.3,22,21415,0,1
WV,"Logan County, West Virginia",6902,2915,3987,54045,36763,14693,2538,15770,2187,30463,4725,115.7,56,stable,95.1,45,34707,0,0
WV,"McDowell County, West Virginia",6943,3196,3747,54047,24921,7748,1595,8604,1653,16352,3248,103.9,32,stable,86.6,26,19835,0,0
WV,"Marion County, West Virginia",8980,4005,4975,54049,43165,24474,3170,25607,3172,50081,6342,77.5,61,stable,60.7,46,56925,0,0
WV,"Marshall County, West Virginia",4128,1676,2452,54051,45182,13971,1738,14765,1607,28736,3345,72.8,34,stable,50.4,24,31978,0,0
WV,"Mason County, West Virginia",5075,2409,2666,54053,36448,11796,1296,12095,1313,23891,2609,87.6,34,stable,74.4,28,27037,0,0
WV,"Mercer County, West Virginia",13236,5322,7914,54055,36195,25765,3623,28569,3502,54334,7125,84,75,stable,65.2,59,61164,0,0
WV,"Mineral County, West Virginia",4562,2071,2491,54057,31790,11880,1750,11854,2065,23734,3815,82.3,32,stable,65.2,26,27451,0,0
WV,"Mingo County, West Virginia",6654,2873,3781,54059,33221,11009,1662,11547,1629,22556,3291,106.5,35,stable,83.1,27,25292,0,0
WV,"Monongalia County, West Virginia",20923,10509,10414,54061,45467,46145,5157,44376,4373,90521,9530,65.9,56,stable,43.2,36,104236,0,0
WV,"Monroe County, West Virginia",2252,894,1358,54063,36918,5882,761,5852,912,11734,1673,63.3,13,rising,46,10,13506,1,0
WV,"Morgan County, West Virginia",2218,879,1339,54065,39324,7057,1471,7458,1323,14515,2794,68.9,18,stable,57.9,15,17524,0,0
WV,"Nicholas County, West Virginia",4636,2006,2630,54067,39171,11361,1372,11541,1512,22902,2884,67.5,25,stable,66.3,25,25594,0,0
WV,"Ohio County, West Virginia",6658,2958,3700,54069,40569,18578,2150,20274,2075,38852,4225,73.5,47,stable,52.8,35,43066,0,0
WV,"Pendleton County, West Virginia",1500,776,724,54071,36953,3204,399,3191,435,6395,834,44.2,6,stable,35.6,5,7229,0,0
WV,"Pleasants County, West Virginia",1260,616,644,54073,44288,3159,334,3257,266,6416,600,98.3,10,stable,75.6,8,7674,0,0
WV,"Pocahontas County, West Virginia",1382,568,814,54075,36827,3544,655,3740,453,7284,1108,78.2,11,stable,55.9,8,8607,0,0
WV,"Preston County, West Virginia",4574,2002,2572,54077,45064,13622,2010,14136,1716,27758,3726,68.1,31,stable,45.8,20,33940,0,0
WV,"Putnam County, West Virginia",5494,2026,3468,54079,56774,25264,2324,26190,2483,51454,4807,76.1,52,stable,48,33,56848,0,0
WV,"Raleigh County, West Virginia",13322,5897,7425,54081,41032,32067,4667,34436,4328,66503,8995,81,86,stable,59.8,64,77510,0,0
WV,"Randolph County, West Virginia",4610,1968,2642,54083,39457,11948,1779,12104,1717,24052,3496,63.3,27,stable,50.7,20,29126,0,0
WV,"Ritchie County, West Virginia",2071,995,1076,54085,37636,4232,754,4496,591,8728,1345,105.7,16,stable,81.5,12,9982,0,0
WV,"Roane County, West Virginia",3165,1382,1783,54087,31813,6351,829,6571,791,12922,1620,76.5,16,stable,65.2,14,14435,0,0
WV,"Summers County, West Virginia",2184,1100,1084,54089,36651,5359,752,5793,539,11152,1291,54.1,11,stable,36.5,8,13239,0,0
WV,"Taylor County, West Virginia",2731,1296,1435,54091,43970,7287,967,7477,801,14764,1768,72.2,17,stable,68.5,15,16912,0,0
WV,"Tucker County, West Virginia",1013,450,563,54093,40533,3067,301,3069,363,6136,664,75.3,9,stable,49.7,6,6966,0,0
WV,"Tyler County, West Virginia",1765,675,1090,54095,38854,3826,615,3884,634,7710,1249,81,11,stable,64,9,8975,0,0
WV,"Upshur County, West Virginia",4189,1928,2261,54097,40330,10452,1736,10744,1471,21196,3207,74,24,stable,59.9,19,24758,0,0
WV,"Wayne County, West Virginia",8468,3971,4497,54099,36318,17510,2711,18273,2887,35783,5598,89.5,51,stable,64.2,36,40971,0,0
WV,"Webster County, West Virginia",2307,1033,1274,54101,29086,3713,652,3833,671,7546,1323,94.6,13,stable,81,10,8755,0,0
WV,"Wetzel County, West Virginia",3169,1354,1815,54103,39096,6968,930,7266,895,14234,1825,87,22,stable,71.2,18,15816,0,0
WV,"Wirt County, West Virginia",792,291,501,54105,39352,2685,251,2492,413,5177,664,78.8,7,stable,54.6,4,5880,0,0
WV,"Wood County, West Virginia",14825,6309,8516,54107,41884,36251,5402,40175,4243,76426,9645,81.9,97,stable,60.5,71,86452,0,0
WV,"Wyoming County, West Virginia",4934,2320,2614,54109,33730,9990,1311,10135,1352,20125,2663,90.3,27,stable,80,24,22151,0,0
WY,"Albany County, Wyoming",9510,4748,4762,56001,42834,17650,1926,16276,1516,33926,3442,40.8,11,stable,29.1,8,37956,0,0
WY,"Big Horn County, Wyoming",1408,632,776,56003,51679,4937,968,4867,900,9804,1868,41.8,7,stable,40.2,7,12022,0,0
WY,"Campbell County, Wyoming",3412,1380,2032,56005,80060,21583,3092,19806,3159,41389,6251,53.1,16,stable,60.1,16,49220,0,0
WY,"Carbon County, Wyoming",2280,948,1332,56007,56825,6819,1089,6058,996,12877,2085,58.4,10,stable,41.6,7,15559,0,0
WY,"Converse County, Wyoming",1308,486,822,56009,62307,6497,587,6052,902,12549,1489,58.3,9,stable,40.6,6,14236,0,0
WY,"Crook County, Wyoming",362,206,156,56011,60445,3201,479,3060,440,6261,919,46.2,5,stable,47.6,5,7444,0,0
WY,"Fremont County, Wyoming",5637,2586,3051,56013,52773,15856,4060,16468,3762,32324,7822,45.7,22,stable,38.6,19,40315,0,0
WY,"Goshen County, Wyoming",2261,1048,1213,56015,42689,5672,964,5569,723,11241,1687,52.5,10,stable,40.5,8,13383,0,0
WY,"Hot Springs County, Wyoming",500,140,360,56017,45278,1942,395,2048,319,3990,714,75.8,7,stable,50.3,4,4741,0,0
WY,"Johnson County, Wyoming",534,294,240,56019,54065,4058,449,3660,379,7718,828,38.2,5,stable,29.9,4,8585,0,0
WY,"Laramie County, Wyoming",9369,3777,5592,56021,60706,40089,5563,41797,4991,81886,10554,52.1,53,falling,42.3,42,97121,0,1
WY,"Lincoln County, Wyoming",1435,662,773,56023,66647,8316,1002,7928,941,16244,1943,32.1,7,stable,26.8,5,18722,0,0
WY,"Natrona County, Wyoming",8407,3605,4802,56025,56871,33677,6119,33595,5518,67272,11637,58.2,48,stable,41.5,35,82178,0,0
WY,"Park County, Wyoming",2024,492,1532,56029,56363,12141,1955,12766,1857,24907,3812,36.3,15,stable,34.2,14,29228,0,0
WY,"Platte County, Wyoming",1391,562,829,56031,38500,3579,837,3622,602,7201,1439,52,7,stable,40,6,8812,0,0
WY,"Sheridan County, Wyoming",2381,1210,1171,56033,55455,12684,1703,13415,1471,26099,3174,52,20,stable,42,15,30009,0,0
WY,"Sweetwater County, Wyoming",5058,2177,2881,56037,69022,19891,3318,18600,2683,38491,6001,39.9,14,stable,28.4,9,44626,0,0
WY,"Teton County, Wyoming",1638,1026,612,56039,75325,8948,2558,9555,1192,18503,3750,23.7,5,stable,29.1,5,23125,0,0
WY,"Uinta County, Wyoming",2845,1453,1392,56041,56569,9132,1413,8711,1503,17843,2916,31.7,6,stable,22.1,4,20822,0,0
WY,"Washakie County, Wyoming",1137,489,648,56043,47652,3349,691,3490,703,6839,1394,50,6,stable,38.2,5,8328,0,0
WY,"Weston County, Wyoming",958,354,604,56045,57738,2927,454,3087,314,6014,768,44.9,4,stable,43.5,4,7234,0,0